정류소명,정류소ID,승차건수(총합계),하차건수(총합계),승차건수(카드),하차건수(카드),승차건수(현금),일평균 승하차건수
(구)국제여객터미널,35051,95,1923,21,1923,74,67
(구)국제여객터미널,---,2512,43,2465,43,47,85
(주)경동세라믹스,89146,341,26,335,26,6,12
(주)경인양행앞,42096,945,923,938,923,7,62
(주)경인양행앞,42097,1322,3536,1294,3536,28,161
(주)대한특수금속,39050,1243,89,1238,89,5,44
(주)두남,39135,147,29,147,29,0,5
(주)세모입구(린나이코리아),37585,1410,1517,1404,1517,6,97
(주)세모입구(린나이코리아),40893,307,556,304,556,3,28
(주)스킨이데아,89388,147,148,147,148,0,9
(주)스킨이데아,89389,628,6,620,6,8,21
(주)씨피엔텍,39133,519,3415,510,3415,9,131
(주)씨피엔텍,39134,2308,439,2297,439,11,91
(주)창원,39029,3624,3208,3601,3208,23,227
(주)창원,39030,4312,3590,4295,3590,17,263
(주)하나금속,39124,3,17,3,17,0,0
17사단.다임메가타운,40895,1882,4284,1853,4284,29,205
17사단입구,40832,24,603,11,603,13,20
2001아울렛,40154,3405,5611,3358,5611,47,300
2001아울렛,40159,30959,13650,30529,13650,430,1486
2001아울렛,40162,11254,21820,11008,21820,246,1102
2001아울렛부평점,40158,5025,2011,4866,2011,159,234
2차풍림아이원,42584,42,12667,30,12667,12,423
3단지,40736,387,1893,357,1893,30,76
3단지관리사무소,40107,2056,573,2032,573,24,87
41번구종점,42174,1978,6131,1946,6131,32,270
510번차고지,36145,835,228,822,228,13,35
540번종점,39470,3694,32,3638,32,56,124
6공단사거리,37577,435,2502,424,2502,11,97
6공단입구,37442,636,1024,620,1024,16,55
6공단입구,37443,1317,1710,1273,1710,44,100
8부두,35181,261,2770,207,2770,54,101
8부두,35182,1615,2215,1556,2215,59,127
CJ인천2공장,35591,254,3156,250,3156,4,113
CJ인천2공장,35592,2489,103,2485,103,4,86
E편한세상,42453,3525,2584,3454,2584,71,203
E편한세상,42649,1334,2347,1312,2347,22,122
E편한세상,42726,2660,1365,2611,1365,49,134
GM물류센터,40568,447,1356,438,1356,9,60
GS25편의점,36142,952,2056,912,2056,40,100
GS내리주유소,44147,1,1,1,1,0,0
GS칼텍스,35168,623,87,597,87,26,23
GS칼텍스,35557,8,2427,6,2427,2,81
GS칼텍스,89220,53,142,53,142,0,6
GS칼텍스,89224,58,1748,58,1748,0,60
GS칼텍스주유소,39814,113,19,111,19,2,4
HD현대인프라코어,36081,787,1540,777,1540,10,77
HD현대인프라코어,36083,2055,1140,2026,1140,29,106
HD현대인프라코어후문,36077,64,700,5,700,59,25
HD현대인프라코어후문,36078,4217,809,4202,809,15,167
JC회관,37383,4341,4473,4256,4473,85,293
KCC아파트,42391,1567,1090,1535,1090,32,88
KG스틸,42008,2628,4773,2618,4773,10,246
KTX광명역4번출구,58057,711,10,711,10,0,24
KT부평지사,40381,9937,6350,9780,6350,157,542
KT부평지사,40384,6743,12648,6592,12648,151,646
KT서인천지사,42932,1786,2663,1759,2663,27,148
KT서인천지사,42933,1529,989,1512,989,17,83
KT송도지점,38568,482,314,476,314,6,26
KT온수분국,43523,609,294,594,294,15,30
KT인천공항지사,35095,330,76,323,76,7,13
KT인천공항지사,35109,7976,3082,7500,3082,476,368
KT인천지사,37415,6230,4684,6088,4684,142,363
KT인천지사,39319,8914,4443,8699,4443,215,445
KT중동지사,55081,789,192,774,192,15,32
KT중동지사,55082,182,1069,180,1069,2,41
LG마그나,89029,5958,1676,5941,1676,17,254
LG마그나,89264,2502,5411,2498,5411,4,263
LG물류센터,39043,312,131,310,131,2,14
LG물류센터,39044,54,445,54,445,0,16
LG아파트후문,42616,371,37,371,37,0,13
LG아파트후문,42617,3,180,3,180,0,6
LG전자(주),42297,4777,3297,4752,3297,25,269
LH1단지,35494,7131,3727,6974,3727,157,361
LH1단지,35495,3711,4809,3531,4809,180,284
LH49단지행복주택아파트,35768,414,676,413,676,1,36
LH49단지행복주택아파트,35769,1325,855,1312,855,13,72
LH7단지,35451,2526,2401,2445,2401,81,164
LH7단지,35452,2808,3037,2730,3037,78,194
LH미추홀3단지,37222,2996,6045,2825,6045,171,301
LH미추홀3단지,37635,6440,3246,6342,3246,98,322
LH웨스턴블루힐정문,89184,943,2347,922,2347,21,109
LH웨스턴블루힐정문,89185,3768,4231,3721,4231,47,266
NKG물류센터,89212,281,26,269,26,12,10
SK.GS주유소,89230,1225,1739,1219,1739,6,98
SK.GS주유소,89231,1650,1379,1635,1379,15,100
SKLPG충전사업소,35636,569,21,525,21,44,19
SKLPG충전사업소,35638,134,614,1,614,133,24
SK뷰아파트,42888,1488,5839,1449,5839,39,244
SK뷰아파트,42889,7426,1196,7029,1196,397,287
SK스카이뷰,37601,435,26840,395,26840,40,909
SK스카이뷰104동,37587,8287,50,8247,50,40,277
SK스카이뷰109동,37607,7134,85,7095,85,39,240
SK인천석유화학,42767,1283,705,1262,705,21,66
SK인천석유화학,42768,225,812,221,812,4,34
SK주유소,42956,528,386,517,386,11,30
SK주유소앞,35287,1912,140,1859,140,53,68
SK주유소앞,35539,111,2468,110,2468,1,85
SK충전소,35085,65,2648,30,2648,35,90
e편한세상 정문,38624,18907,884,18634,884,273,659
e편한세상(109동 앞),32062,733,1399,721,1399,12,71
e편한세상(109동앞),38643,1314,545,1250,545,64,61
e편한세상1차(정문),35662,654,1215,605,1215,49,62
e편한세상1차(정문),35663,1673,485,1650,485,23,71
e편한세상계양,41037,14546,3527,14403,3527,143,602
e편한세상계양,41038,5215,12931,5091,12931,124,604
e편한세상영종센텀베뉴정문,35510,924,3497,910,3497,14,147
e편한세상영종오션하임,35674,1899,1226,1821,1226,78,104
e편한세상영종오션하임,35761,731,1090,704,1090,27,60
e편한세상영종하늘도시,35646,350,505,350,505,0,28
e편한세상영종하늘도시,35647,214,368,202,368,12,19
gym80fitness,37081,2433,855,2379,855,54,109
가경공원,89365,985,726,970,726,15,57
가구단지사거리,37455,3568,5457,3512,5457,56,300
가구단지사거리,37456,3591,2159,3551,2159,40,191
가구전시장,42072,410,663,399,663,11,35
가구전시장,42074,748,618,744,618,4,45
가나안마을앞,43904,9,33,9,33,0,1
가나안마을앞,43905,43,4,43,4,0,1
가능포,43969,1,0,1,0,0,0
가능포,43970,1,20,1,20,0,0
가림고등학교,42078,13810,13058,13492,13058,318,895
가야,42807,605,1,586,1,19,20
가야,42808,126,1452,123,1452,3,52
가양역.우성아파트,25107,9235,6327,9196,6327,39,518
가오대입구,80033,220,393,194,393,26,20
가오대입구,80034,85,667,80,667,5,25
가원초등학교,42952,6536,4601,6451,4601,85,371
가원초등학교,89118,2851,5668,2760,5668,91,283
가재우물터,35678,9,4,9,4,0,0
가재우물터,35700,3,12,3,12,0,0
가재울사거리,42039,2432,5311,2402,5311,30,258
가재울사거리,42042,8354,5035,8266,5035,88,446
가재울역,42034,2155,2775,2133,2775,22,164
가재울역,42035,3816,2112,3738,2112,78,197
가정(루원시티)역,89050,4779,44611,4732,44611,47,1646
가정(루원시티)역,89051,60219,6711,59993,6711,226,2231
가정(루원시티)역,89075,74655,74678,74230,74678,425,4977
가정(루원시티)역,89078,84690,72801,84217,72801,473,5249
가정3동성당,42226,411,3353,407,3353,4,125
가정LH3단지정문앞,89041,18267,3684,18082,3684,185,731
가정고등학교,42200,11702,4667,11521,4667,181,545
가정고등학교,42203,3769,7479,3675,7479,94,374
가정교차로,89390,174,720,152,720,22,29
가정교차로,89391,537,3465,533,3465,4,133
가정동성당,89102,3516,3346,3384,3346,132,228
가정동성당,89105,2717,1841,2671,1841,46,151
가정보금자리,89119,1377,405,1371,405,6,59
가정보금자리,89120,38,1442,34,1442,4,49
가정여자중학교,42041,303,6974,289,6974,14,242
가정여중입구,89303,836,804,819,804,17,54
가정중앙시장역,42215,1281,1024,1260,1024,21,76
가정중앙시장역,42219,1191,1790,1163,1790,28,99
가정택지삼거리,89385,335,201,326,201,9,17
가정택지삼거리,89386,215,393,200,393,15,20
가정휴먼시아3단지,89186,1133,1515,1120,1515,13,88
가정휴먼시아3단지,89187,1724,1772,1656,1772,68,116
가좌2동행정복지센터,42073,5684,273,5640,273,44,198
가좌2동행정복지센터,42076,166,4972,146,4972,20,171
가좌3동행정복지센터,42075,13050,14207,12877,14207,173,908
가좌4동행정복지센터,42062,5097,6999,4994,6999,103,403
가좌고등학교,42060,15725,12178,15399,12178,326,930
가좌고등학교,42061,5582,8646,5437,8646,145,474
가좌공단,42526,74,11307,54,11307,20,379
가좌공단,42945,8792,14,8714,14,78,293
가좌교회,42055,3752,8404,3670,8404,82,405
가좌교회,42057,4289,3960,4206,3960,83,274
가좌녹지공원,42029,1268,3567,1256,3567,12,161
가좌녹지공원,42030,1656,1062,1647,1062,9,90
가좌농협,42066,8376,7398,8184,7398,192,525
가좌농협,42067,6091,5874,5897,5874,194,398
가좌동차고,42939,2640,300,2043,300,597,98
가좌동차고지,42522,539,1045,46,1045,493,52
가좌두산위브104동앞,42090,5736,3524,5612,3524,124,308
가좌사거리,42043,47,245,38,245,9,9
가좌사거리,42044,454,4216,441,4216,13,155
가좌진주아파트,42100,13718,28676,13475,28676,243,1413
가좌체육공원,42058,7275,993,7183,993,92,275
가좌초등학교,42069,4344,4949,4247,4949,97,309
가좌초등학교,42070,4986,2677,4890,2677,96,255
가좌테니스장,37454,2440,1019,2429,1019,11,115
가좌테니스장,37457,889,1564,870,1564,19,81
가좌현대아파트,42130,8335,2640,8173,2640,162,365
가좌현대아파트,42133,925,8309,908,8309,17,307
가좌홈플러스(쌍마아파트),42101,10289,7773,9945,7773,344,602
가좌홈플러스(쌍마아파트),42103,7640,11363,7390,11363,250,633
가좌환경사업소,42631,7811,4281,7734,4281,77,403
가좌환경사업소 북측,89341,217,310,213,310,4,17
가좌환경사업소북측,89342,19,222,19,222,0,8
가천대학교,38270,1253,864,1178,864,75,70
가천대학교,38284,8168,2635,7975,2635,193,360
가천대학교(노인복지회관),38269,818,952,794,952,24,59
가천의대,43237,0,29,0,29,0,0
가천의대,43897,18,1,17,1,1,0
가톨릭대,43156,2,1,2,1,0,0
가톨릭대,43325,0,50,0,50,0,1
가현오일뱅크,42734,28,15,27,15,1,1
가현중학교,42722,3175,3166,3106,3166,69,211
가현초교앞(루에블리아파트),89242,3431,4555,3290,4555,141,266
가현초교앞(센트럴타운아파트),89243,5980,1775,5912,1775,68,258
각곡,43602,2,83,2,83,0,2
각곡,43772,192,11,182,11,10,6
간석4거리,39538,332,310,317,310,15,21
간석4동새마을금고,39343,3276,6178,3127,6178,149,315
간석4동새마을금고,39346,3333,2417,3254,2417,79,191
간석4동행정복지센터,39403,4329,8473,4296,8473,33,426
간석4동행정복지센터,39412,5609,3112,5543,3112,66,290
간석금호어울림아파트,39334,27478,13535,26949,13535,529,1367
간석남부역,37429,3585,789,3502,789,83,145
간석남부역,37435,7630,2627,7495,2627,135,341
간석남부역,37529,1209,3052,1195,3052,14,142
간석동용광경로당,39394,972,588,961,588,11,52
간석래미안.자이,39333,17423,19184,17248,19184,175,1220
간석북부역,39806,3532,56,3448,56,84,119
간석북부역,39807,91,2324,61,2324,30,80
간석북부역·우성1차,39368,12372,4671,12344,4671,28,568
간석북부역·우성1차,39370,5156,9847,5134,9847,22,500
간석사거리,39413,13893,9631,13739,9631,154,784
간석사거리,39414,4942,10031,4905,10031,37,499
간석사거리,39430,2265,2725,2243,2725,22,166
간석사거리(상인천중학교),39422,13276,29829,13044,29829,232,1436
간석사거리(상인천중학교),39426,32673,19029,32402,19029,271,1723
간석시장,39434,13171,32135,12950,32135,221,1510
간석시장,39436,58154,32902,57535,32902,619,3035
간석시장,39437,15682,20947,15503,20947,179,1220
간석오거리,39460,18029,14032,17694,14032,335,1068
간석오거리,39597,4898,4204,4873,4204,25,303
간석오거리(교원공제조합),39444,36538,29486,36264,29486,274,2200
간석오거리(인천웨딩홀),39406,8365,11702,8099,11702,266,668
간석오거리(인천웨딩홀),39423,34630,20727,34193,20727,437,1845
간석오거리역(7번출구),39447,17171,31023,17009,31023,162,1606
간석오거리역(8번출구),39449,61111,73633,60880,73633,231,4491
간석지구대,39535,517,733,495,733,22,41
간석지구대,39536,548,594,529,594,19,38
간석풍림아파트,92053,471,541,460,541,11,33
간석한신더휴아파트맞은편,37447,2195,503,2182,503,13,89
간재울초등학교,42347,6087,4115,5909,4115,178,340
간촌,43504,22,72,20,72,2,3
간촌,43518,85,22,79,22,6,3
갈산대동아파트,40550,243,764,235,764,8,33
갈산동아아파트,40567,1468,1627,1454,1627,14,103
갈산동입구,40622,41,4695,41,4695,0,157
갈산동천주교회,40652,883,4629,834,4629,49,183
갈산동천주교회맞은편,40650,5323,4538,5253,4538,70,328
갈산두산아파트,40544,4082,6006,3997,6006,85,336
갈산사거리,40631,2787,4291,2721,4291,66,235
갈산사거리,40634,3216,4961,3161,4961,55,272
갈산새마을금고,40635,8792,2162,8654,2162,138,365
갈산시장,40628,6877,6176,6795,6176,82,435
갈산시장.갈산도서관,40629,2390,6921,2293,6921,97,310
갈산역,40601,36725,12882,36542,12882,183,1653
갈산역,40602,10617,43938,10519,43938,98,1818
갈산역(1번출구),40604,24618,6935,24434,6935,184,1051
갈산역(부평4공단)4번출구,40606,6712,17968,6650,17968,62,822
갈산주공1단지,40578,3058,1928,2975,1928,83,166
갈산주공1단지105동,40813,7618,2995,7527,2995,91,353
갈산주공2단지,40562,389,1110,387,1110,2,49
갈산주공2단지,40577,4457,7431,4304,7431,153,396
갈산태화아파트,40542,466,1226,449,1226,17,56
갈산태화아파트,40664,5051,830,4978,830,73,196
갈산태화아파트,40666,224,1543,216,1543,8,58
갈산태화아파트,40667,694,2627,682,2627,12,110
갈월초등학교,40531,89,1158,86,1158,3,41
갈현경로당,41491,42,253,42,253,0,9
갈현경로당앞,41607,196,40,195,40,1,7
갈현교,41608,127,1,120,1,7,4
갈현교,41609,100,126,1,126,99,7
갈현교입구,41492,540,29,524,29,16,18
갈현교입구,41617,1,207,0,207,1,6
갈현동마을,41351,790,708,776,708,14,49
갈현동마을,41352,318,1483,315,1483,3,60
갑곶돈대.강화전쟁박물관,43365,10,8,10,8,0,0
갑곶돈대.강화전쟁박물관,43728,17,19,16,19,1,1
갑곶돈대입구,43367,7,17,7,17,0,0
갑곶돈대입구,43726,15,9,15,9,0,0
갑륭초교,43374,0,4,0,4,0,0
갑륭초교,43724,6,164,6,164,0,5
갑문,35125,19,471,19,471,0,16
갑문,35504,145,14,142,14,3,5
강남시장,42172,21367,13898,20770,13898,597,1175
강남시장,42173,12600,11942,12332,11942,268,818
강남역.역삼세무서,23287,1051,1334,1051,1334,0,79
강남역도시에빛,31076,2754,7964,2754,7964,0,357
강남역서초현대타워앞,31016,52353,34199,52263,34199,90,2885
강남중교,43213,91,22,91,22,0,3
강남중교,43278,10,192,8,192,2,6
강서중학교,43660,2,116,2,116,0,3
강서중학교,43898,181,17,168,17,13,6
강인여객,40020,1167,1579,1123,1579,44,91
강인여객,40022,1246,911,1223,911,23,71
강화갯벌장어,43671,3,1,3,1,0,0
강화경찰서,43209,229,18,198,18,31,8
강화경찰서,43624,5,226,5,226,0,7
강화고등학교,43564,7,25,7,25,0,1
강화고등학교,43761,157,112,157,112,0,8
강화군 행복센터,43055,99,1503,96,1503,3,53
강화군 행복센터,43056,1,189,1,189,0,6
강화군노인문화센터,90373,0,53,0,53,0,1
강화군노인문화센터,90374,33,4,33,4,0,1
강화군청,43065,3497,649,3280,649,217,138
강화군청,43108,754,2610,719,2610,35,112
강화루지.강남상회,43150,158,44,157,44,1,6
강화루지.강남상회,43250,91,239,87,239,4,11
강화마니산,43001,48,54,43,54,5,3
강화마니산,43002,398,134,372,134,26,17
강화문화원.종합전시관,43097,2,63,2,63,0,2
강화문화원.종합전시관,43098,46,485,45,485,1,17
강화병원,43088,34,1171,29,1171,5,40
강화병원,43089,951,36,947,36,4,32
강화산단,90123,0,11,0,11,0,0
강화산단입구,90096,0,5,0,5,0,0
강화산단입구,90097,19,0,19,0,0,0
강화산성서문,43080,0,15,0,15,0,0
강화산성서문,43081,19,50,19,50,0,2
강화서문,43063,533,423,513,423,20,31
강화서문,43064,454,392,432,392,22,28
강화수양관앞,43467,34,20,34,20,0,1
강화수양관앞,43732,9,22,9,22,0,1
강화슈퍼,43066,619,1099,606,1099,13,57
강화슈퍼,43068,1617,297,1473,297,144,63
강화실버케어스앞,43975,40,144,39,144,1,6
강화실버케어스앞,43976,93,72,93,72,0,5
강화아시아드BMX경기장,43799,1,110,1,110,0,3
강화여자중학교,90334,0,57,0,57,0,1
강화역사박물관(고인돌),43601,334,20,315,20,19,11
강화역사박물관(고인돌),43670,30,374,30,374,0,13
강화장례식장,43918,1371,62,1314,62,57,47
강화장례식장,43946,62,1587,32,1587,30,54
강화중학교,43207,23,36,23,36,0,1
강화중학교,43623,8,38,8,38,0,1
강화터미널,43058,0,1,0,1,0,0
강화터미널,43096,46946,960,43988,960,2958,1596
개항동 어울터,35197,9530,1942,9210,1942,320,382
개항동 어울터,35198,2387,9040,2316,9040,71,380
개화2치안센터,25023,53,1929,51,1929,2,66
개화2치안센터,25024,2711,45,2698,45,13,91
개화역1번출구.개화검문소,25030,163,7771,160,7771,3,264
개화역1번출구.개화검문소,25031,2869,285,2840,285,29,105
개화역광역환승센터,25182,1569,2397,1565,2397,4,132
갤러리84입구,35666,36,6,32,6,4,1
갤러리84입구,35667,18,31,18,31,0,1
갯벌슈퍼,43410,7,23,7,23,0,1
갯벌슈퍼,43513,19,15,19,15,0,1
거북시장,42132,14640,12224,14182,12224,458,895
거북시장,42136,13702,11541,13349,11541,353,841
거산정공.(주)록키,39137,1392,1681,1384,1681,8,102
거잠포선착장,35302,164,800,164,800,0,32
거잠포선착장,35303,1007,160,1006,160,1,38
거잠포회센터,35588,100,37,68,37,32,4
건설기술교육원,39353,7081,11505,7041,11505,40,619
건설기술교육원,39354,5116,4285,5080,4285,36,313
건영아파트,38069,16069,40224,15846,40224,223,1876
건일아파트,43015,376,175,367,175,9,18
건일아파트,43094,167,239,157,239,10,13
건지사거리,42882,82,1,81,1,1,2
건지사거리,42883,0,256,0,256,0,8
건평,43168,64,71,58,71,6,4
건평,43186,10,42,10,42,0,1
건평리,43187,22,26,20,26,2,1
건평리,43651,8,47,8,47,0,1
건평마을회관,43594,16,40,16,40,0,1
건평입구,43170,1,18,1,18,0,0
건평입구,43331,23,11,23,11,0,1
걸포북변역,35560,45,3318,43,3318,2,112
걸포북변역,35610,2699,146,2670,146,29,94
걸포사거리.우리병원,35561,254,379,244,379,10,21
검단1차피오레·금호어울림아파트,89457,153,142,151,142,2,9
검단1차피오레·금호어울림아파트,89458,21,436,17,436,4,15
검단LH행복주택,89408,7580,2312,7499,2312,81,329
검단공구상가,89053,103,482,76,482,27,19
검단공구상가,89065,304,202,293,202,11,16
검단노인복지관,42695,144,403,132,403,12,18
검단농기구센터,89316,69,15,69,15,0,2
검단농기구센터,89324,2,131,2,131,0,4
검단농협,42432,25812,9189,25180,9189,632,1166
검단농협,42434,4898,13940,4759,13940,139,627
검단동행정복지센터(검단고교),42441,3776,7927,3616,7927,160,390
검단동행정복지센터(검단고교),42445,3988,4672,3879,4672,109,288
검단로지스틱스파크,41339,776,129,772,129,4,30
검단로지스틱스파크,42395,163,1346,141,1346,22,50
검단메가박스,42383,2176,1660,2118,1660,58,127
검단메가박스,42384,953,2288,906,2288,47,108
검단모아엘가그랑데아파트,42483,43,447,43,447,0,16
검단사거리역,42419,13381,15298,13138,15298,243,955
검단사거리역,42426,2255,8390,2231,8390,24,354
검단사거리역,42427,7510,3129,7434,3129,76,354
검단사거리역,42537,10224,11211,9991,11211,233,714
검단신도시예미지더시그너스,89415,353,277,352,277,1,21
검단신도시예미지더시그너스,89416,4,281,4,281,0,9
검단신도시우미린리버포레,89409,3413,6795,3355,6795,58,340
검단오류공단,42702,20,491,9,491,11,17
검단오류공단,42703,415,15,401,15,14,14
검단오류역,89057,6539,641,6504,641,35,239
검단오류역,89060,667,6090,634,6090,33,225
검단오류역우방아이유쉘,89067,313,719,309,719,4,34
검단오류역우방아이유쉘,89068,893,139,867,139,26,34
검단오류풍림아이원,89251,94,409,92,409,2,16
검단오류풍림아이원,89252,314,153,309,153,5,15
검단우방아이유쉘아파트,42688,319,414,292,414,27,24
검단원흥아파트,42400,1874,1040,1803,1040,71,97
검단원흥아파트,42401,1387,3190,1336,3190,51,152
검단지식산업센타,89054,8626,152,8397,152,229,292
검단지식산업센타,89063,101,6375,100,6375,1,215
검단초등학교,42475,8245,3645,8053,3645,192,396
검단초등학교,42482,3818,5472,3747,5472,71,309
검단초등학교,89332,33,124,32,124,1,5
검단초등학교,89333,123,113,121,113,2,7
검단출장소,42423,15654,10874,15334,10874,320,884
검단출장소,42424,4322,10679,4202,10679,120,500
검단탑종합병원,42877,396,573,389,573,7,32
검단하나아파트,42421,2427,559,2392,559,35,99
검단하나아파트,42422,513,399,506,399,7,30
검단힐스테이트5차아파트,42557,7,159,5,159,2,5
검단힐스테이트5차아파트,42558,143,478,135,478,8,20
검문소,43662,1,1,1,1,0,0
검문소,43812,18,93,18,93,0,3
검문소,90042,2,2,2,2,0,0
검문소,90043,18,116,17,116,1,4
검바위역,42348,4538,945,4436,945,102,182
검바위역,42349,1503,3074,1477,3074,26,152
검암경서동행정복지센터,42352,2001,6227,1943,6227,58,274
검암경서동행정복지센터,42353,6139,1955,5894,1955,245,269
검암사거리,42356,2289,3183,2252,3183,37,182
검암사거리,42357,4373,1691,4266,1691,107,202
검암사거리,42358,4876,1555,4753,1555,123,214
검암역(시내방면),42364,20215,2576,20005,2576,210,759
검암역(원당방면),42363,1754,26806,1710,26806,44,952
검암역.서해그랑블아파트,42360,4875,4273,4824,4273,51,304
검암역로열파크씨티푸르지오1단지,89167,1067,4,972,4,95,35
검암역로열파크씨티푸르지오1단지,89168,7,598,0,598,7,20
검암역로열파크씨티푸르지오2단지,89169,389,7,375,7,14,13
검암역로열파크씨티푸르지오2단지,89170,71,635,1,635,70,23
검암역입구,42851,9627,5562,9546,5562,81,506
검암역입구,42852,5828,5871,5793,5871,35,389
검암역입구(시천교밑),89250,10486,2867,10466,2867,20,445
검암중학교,42359,3747,1479,3645,1479,102,174
검암중학교,42362,2633,3092,2608,3092,25,190
검암초등학교,42361,415,5976,401,5976,14,213
경기국제통상고.포도마을뉴서울.중앙공원,55042,456,2108,431,2108,25,85
경기국제통상고.포도마을뉴서울.중앙공원,55043,1683,897,1628,897,55,86
경기도교육청학생교육원,43162,1,82,1,82,0,2
경기도교육청학생교육원,43222,193,37,192,37,1,7
경기주유소,43051,103,365,103,365,0,15
경남1차,40343,9020,352,8839,352,181,312
경남1차아파트,40376,14250,7163,14050,7163,200,713
경남2차,40305,8588,75,8499,75,89,288
경남아너스빌,42099,3357,1486,3240,1486,117,161
경남아너스빌,42102,1350,2861,1313,2861,37,140
경남아너스빌아파트,42110,4591,2987,4511,2987,80,252
경남아너스빌아파트,42111,1961,2585,1896,2585,65,151
경남아파트,35143,7749,2967,7612,2967,137,357
경남아파트,35147,640,2104,602,2104,38,91
경남아파트,38281,8413,7077,8244,7077,169,516
경남아파트,41011,16564,4266,16234,4266,330,694
경남아파트,41014,4020,8619,3987,8619,33,421
경남아파트,42332,6839,2493,6729,2493,110,311
경남아파트,42334,2609,7254,2580,7254,29,328
경남아파트308동앞,40334,59,6876,59,6876,0,231
경남아파트311동앞,40300,18,5611,18,5611,0,187
경남아파트313동앞,40287,19,6358,17,6358,2,212
경동택배,89315,54,1,53,1,1,1
경동택배,89325,0,41,0,41,0,1
경명초등학교,89216,1314,531,1293,531,21,61
경명초등학교,89277,4519,7419,4501,7419,18,397
경명초등학교,89278,4310,5447,4271,5447,39,325
경방신약,39136,5514,1526,5478,1526,36,234
경방신약,39138,2538,8889,2522,8889,16,380
경복예식장,39399,9802,4639,9526,4639,276,481
경서농원,42333,178,465,174,465,4,21
경서농원,42335,85,1122,69,1122,16,40
경서지구입구,42303,842,5267,834,5267,8,203
경서지구입구,42671,2492,2573,2461,2573,31,168
경서지구입구,42672,3989,2749,3913,2749,76,224
경서초등학교,42569,4363,2304,4297,2304,66,222
경서초등학교,42570,2776,2464,2747,2464,29,174
경신마을,39646,186,170,184,170,2,11
경신마을,39982,203,973,191,973,12,39
경신아파트,41216,2033,1141,2016,1141,17,105
경신아파트,41223,1863,3590,1810,3590,53,181
경연초중학교,89271,6627,4470,6476,4470,151,369
경연초중학교,89272,3688,5341,3667,5341,21,300
경연초중학교·청라센텀로제비앙,89286,2138,969,2056,969,82,103
경연초중학교·호반베르디움6차,89285,1860,1776,1815,1776,45,121
경인계량소,42549,1255,5,1233,5,22,42
경인계량소,42550,3,841,3,841,0,28
경인교대.부평향교,41138,842,1148,810,1148,32,66
경인교대.부평향교,41139,783,918,764,918,19,56
경인교대역입구,41428,9653,7322,9431,7322,222,565
경인교대역입구,41429,8220,9045,8040,9045,180,575
경인교회앞,40077,985,3619,956,3619,29,153
경인방송,37003,111,152,110,152,1,8
경인방송,37004,109,219,99,219,10,10
경인산업,39688,778,1408,766,1408,12,72
경인아라뱃길여객터미널,42869,451,12,446,12,5,15
경인여대,41277,7107,11441,7087,11441,20,618
경인여대,41278,4343,5169,4330,5169,13,317
경인특장,42547,226,1,214,1,12,7
경인항다목적부두,89151,80,1,77,1,3,2
경인항다목적부두,89152,2,143,2,143,0,4
경전말,43934,30,2,28,2,2,1
경제자유구역청,38514,2216,2166,2180,2166,36,146
경제자유구역청,38515,3004,3518,2961,3518,43,217
경진브로아,39042,985,1208,978,1208,7,73
경흥빌라,43372,371,8,355,8,16,12
경흥빌라,43616,3,184,3,184,0,6
경희유치원앞,39991,151,574,142,574,9,24
경희유치원앞,39992,180,231,179,231,1,13
계량소,40195,2226,314,2183,314,43,84
계룡리슈빌,55225,6611,2130,6608,2130,3,291
계산3동행정복지센터,41649,74,48,73,48,1,4
계산3동행정복지센터,41656,153,127,149,127,4,9
계산공고,41167,3570,3256,3466,3256,104,227
계산공고,41170,5250,8599,5165,8599,85,461
계산공고앞,41169,2845,1958,2763,1958,82,160
계산국민체육센터,41276,2078,3053,2047,3053,31,171
계산국민체육센터,41613,1882,2197,1867,2197,15,135
계산동수협,41533,4281,5033,4189,5033,92,310
계산동아아파트,41231,222,26,215,26,7,8
계산동우체국,41427,6386,3705,6336,3705,50,336
계산삼거리,41196,263,217,253,217,10,16
계산삼거리(신도브래뉴),41199,10226,10194,10088,10194,138,680
계산삼거리(신도브래뉴),41201,4455,8360,4386,8360,69,427
계산시장,41176,4112,4596,4044,4596,68,290
계산여고,41576,952,864,930,864,22,60
계산여자고등학교,41221,38,283,34,283,4,10
계산여자고등학교,41224,1159,1032,1126,1032,33,73
계산역,41247,6311,5617,6270,5617,41,397
계산역,41371,11092,69,11048,69,44,372
계산역,41426,27530,22232,27338,22232,192,1658
계산역,41431,24445,30342,24246,30342,199,1826
계산우체국,41430,10493,11650,10372,11650,121,738
계산전통시장,41648,84,24,83,24,1,3
계산전통시장,41657,36,223,36,223,0,8
계산주공아파트,41423,12675,13906,12412,13906,263,886
계산중학교,41577,321,40,320,40,1,12
계산현대아파트,41650,21,34,21,34,0,1
계양1동주민자치센터,41476,7671,1287,7526,1287,145,298
계양1동주민자치센터,41520,488,7677,450,7677,38,272
계양3동행정복지센터,41525,421,800,419,800,2,40
계양3동행정복지센터,41526,772,492,769,492,3,42
계양CGV,41140,3443,3517,3395,3517,48,232
계양경찰서,41184,10109,7442,10021,7442,88,585
계양경찰서,41185,5942,8825,5873,8825,69,492
계양경찰서,41195,20630,5856,20179,5856,451,882
계양경찰서·계양구청,41194,4340,16707,4266,16707,74,701
계양구의회,41123,5784,4711,5702,4711,82,349
계양구의회,41124,5805,6044,5612,6044,193,394
계양구청,41177,4473,4247,4457,4247,16,290
계양구청,41180,7907,9340,7778,9340,129,574
계양구청,41188,3890,1760,3826,1760,64,188
계양구청,41197,24,2338,24,2338,0,78
계양구청앞,41204,7520,3769,7387,3769,133,376
계양국제어학관,41651,17,41,17,41,0,1
계양도서관,41251,6309,10438,6199,10438,110,558
계양문화회관,41248,1766,1493,1741,1493,25,108
계양문화회관,41255,2833,4180,2792,4180,41,233
계양산성박물관,41285,1328,2039,1296,2039,32,112
계양산성박물관,41286,1053,2168,1032,2168,21,107
계양산장미원 입구(계산동자연풀장),41186,909,611,909,611,0,50
계양산장미원 입구(계산동자연풀장),41189,493,1160,478,1160,15,55
계양산전통시장,41297,722,4700,709,4700,13,180
계양산전통시장,41298,4741,1377,4560,1377,181,203
계양산전통시장,41306,18362,17887,18079,17887,283,1208
계양산지구대,41281,896,1232,887,1232,9,70
계양산지구대,41282,791,1194,757,1194,34,66
계양새마을금고,41094,1428,1550,1391,1550,37,99
계양새마을금고,41097,1693,2187,1642,2187,51,129
계양세무서,41054,1166,1061,1146,1061,20,74
계양세무서,41058,657,1064,650,1064,7,57
계양센트레빌1단지,41550,5559,5213,5373,5213,186,359
계양센트레빌1단지,41627,997,556,997,556,0,51
계양센트레빌1단지,41628,197,790,197,790,0,32
계양센트레빌1단지(111동앞),41551,6944,5699,6909,5699,35,421
계양센트레빌2단지,41625,240,808,234,808,6,34
계양여성회관,41404,3292,4166,3244,4166,48,248
계양역,41357,106915,52913,106558,52913,357,5327
계양역,41358,61095,92302,60848,92302,247,5113
계양역(귤현역방면),41659,4423,63,4378,63,45,149
계양임광그대가아파트,41118,3547,173,3409,173,138,124
계양종합사회복지관,41120,587,1491,583,1491,4,69
계양종합사회복지관,41121,1595,682,1542,682,53,75
계양중학교,41340,2894,1240,2799,1240,95,137
계양중학교,41341,1751,7504,1694,7504,57,308
계양체육관(아시아드양궁장),41454,436,939,434,939,2,45
계양체육관(아시아드양궁장),41455,1881,688,1869,688,12,85
계양체육관(아시아드양궁장),41567,2434,616,2429,616,5,101
계양체육관(아시아드양궁장),41568,655,4352,652,4352,3,166
계양체육관(효성해링턴플레이스),41440,3784,871,3763,871,21,155
계양체육관.대동아파트,41173,52,1704,25,1704,27,58
고구1리입구,90006,69,6,62,6,7,2
고구1리입구,90007,3,51,3,51,0,1
고구2리마을회관입구,90014,2,101,2,101,0,3
고구2리마을회관입구,90015,121,5,116,5,5,4
고구저수지,90008,11,35,11,35,0,1
고구저수지,90009,34,9,34,9,0,1
고구촌,90012,1,63,1,63,0,2
고구촌,90013,82,2,73,2,9,2
고능2리 종점,90372,11,3,10,3,1,0
고능2리능촌마을회관,90371,0,4,0,4,0,0
고능리공소,90208,58,60,55,60,3,3
고능리입구,43291,0,46,0,46,0,1
고능리입구,43534,51,1,50,1,1,1
고다니마을9단지,80362,114,60,110,60,4,5
고려산업,39486,864,1414,861,1414,3,75
고려양행,39111,1037,1662,1016,1662,21,89
고려저수지입구,43249,49,90,49,90,0,4
고려저수지입구,43486,55,26,55,26,0,2
고비고개정상,43569,6,3,5,3,1,0
고비고개정상,43844,5,28,5,28,0,1
고산마을입구,90016,4,65,4,65,0,2
고산마을입구,90017,49,7,48,7,1,1
고산촌,43544,147,40,133,40,14,6
고산촌,43779,36,108,35,108,1,4
고상골,43269,4,58,3,58,1,2
고상골,43382,41,6,41,6,0,1
고상골입구,43266,92,7,91,7,1,3
고상골입구,43552,12,73,8,73,4,2
고속터미널,31017,14539,262,14524,262,15,493
고속터미널,31018,428,23422,428,23422,0,795
고시기(가재골),43770,19,0,14,0,5,0
고시기(가재골),90126,1,4,1,4,0,0
고염나무골,35473,22,176,22,176,0,6
고염나무골,35474,243,14,242,14,1,8
고인돌입구,43550,0,21,0,21,0,0
고인돌체육관(태권도경기장),43383,1,4,1,4,0,0
고인돌체육관앞,90045,82,474,81,474,1,18
고인돌체육관앞,90046,534,122,524,122,10,21
고잔고등학교,39691,218,2649,211,2649,7,95
고잔마을,43284,61,0,57,0,4,2
고잔마을,43532,0,39,0,39,0,1
고창마을.KCC,80328,315,158,315,158,0,15
고창촌,43076,36,87,36,87,0,4
고창촌입구,43166,13,1,13,1,0,0
고창촌입구,43345,1,42,1,42,0,1
고천3리마을회관,43341,95,3,77,3,18,3
고천3리마을회관,43574,5,54,3,54,2,1
고천5리마을회관,90341,10,0,10,0,0,0
고천5리마을회관,90345,1,24,1,24,0,0
고천교,43339,8,20,5,20,3,0
고천교,43849,22,4,15,4,7,0
고촌역,80061,4205,577,4201,577,4,159
고촌역,80062,518,7425,518,7425,0,264
고합아파트,70036,167,106,163,106,4,9
고향산천,43464,21,10,21,10,0,1
고향산천,43610,14,20,14,20,0,1
곡촌,43427,15,18,13,18,2,1
곡촌,43457,89,15,85,15,4,3
곡촌,43789,53,22,47,22,6,2
곡촌,43816,7,105,4,105,3,3
곤능,43197,6,72,6,72,0,2
곤능,43319,39,1,35,1,4,1
골드클래스,42936,211,892,177,892,34,36
공개마을,90195,28,5,25,5,3,1
공개마을,90196,6,20,5,20,1,0
공구상가,36092,413,1703,392,1703,21,70
공구상가.간동입구,80021,1004,109,977,109,27,37
공군8547부대앞,35718,21,41,21,41,0,2
공군8547부대앞,35719,6,114,4,114,2,4
공단공구상가,92048,1,28,1,28,0,0
공단공원앞,42739,154,235,154,235,0,12
공단공원앞,42740,239,77,239,77,0,10
공단본부,42270,352,941,348,941,4,43
공단본부,42756,3172,965,3165,965,7,137
공단본부,42757,932,2503,906,2503,26,114
공단사거리,42995,4,890,4,890,0,29
공단사거리,42996,1207,7,1166,7,41,40
공단사거리,89069,10,288,7,288,3,9
공단사거리,89070,358,487,344,487,14,28
공단소방서,39062,1321,3444,1318,3444,3,158
공단시장,37426,3133,5822,3078,5822,55,298
공단시장,37427,7627,3120,7554,3120,73,358
공단오거리,40565,1801,659,1771,659,30,82
공단오거리,40566,421,2539,420,2539,1,98
공단유통상가,42940,56,1170,45,1170,11,40
공단유통상가,42941,1197,45,1093,45,104,41
공단자동차,42022,1587,2163,1557,2163,30,125
공단치안센터,37444,1781,894,1755,894,26,89
공단치안센터,37445,415,1797,410,1797,5,73
공단회관,39119,1404,3935,1393,3935,11,177
공단회관,39123,3305,1140,3292,1140,13,148
공설운동장,43091,32,346,31,346,1,12
공설운동장,43092,156,183,153,183,3,11
공숙입구,43290,6,68,5,68,1,2
공숙입구,43490,42,42,41,42,1,2
공영산업,89148,4,575,4,575,0,19
공작아파트,39479,1968,3453,1905,3453,63,180
공작아파트,39480,2673,4563,2641,4563,32,241
공장단지입구,42555,197,147,191,147,6,11
공촌마을,42323,4795,3082,4681,3082,114,262
공촌마을,42598,2371,4215,2305,4215,66,219
공촌사거리,42324,16172,9805,16125,9805,47,865
공촌사거리,42330,14172,14493,14085,14493,87,955
공촌사거리,42331,591,526,587,526,4,37
공촌사거리(한국아파트),42322,4916,4759,4867,4759,49,322
공촌정수장,42340,195,115,191,115,4,10
공촌정수장,42341,72,303,70,303,2,12
공항고등학교,35116,2822,436,2618,436,204,108
공항고속도로진입(미정차),35644,1,0,1,0,0,0
공항교회앞,35123,1004,2038,995,2038,9,101
공항신도시(메디컬사거리),35258,555,1679,536,1679,19,74
공항중학교,35117,842,1867,837,1867,5,90
공항초등학교,35087,121,388,119,388,2,16
공항회센터,35745,3,0,3,0,0,0
관곡마을,90104,0,3,0,3,0,0
관곡마을,90105,20,0,19,0,1,0
관광밸트입구,43874,0,3,0,3,0,0
관광밸트입구,43875,4,0,4,0,0,0
관교여자중학교,37226,9125,8627,8930,8627,195,591
관교여자중학교,37229,2497,2483,2432,2483,65,166
관교여자중학교,37231,3372,3955,3229,3955,143,244
관교중학교,37200,242,1031,239,1031,3,42
관교중학교(약수터),37202,4703,7396,4605,7396,98,403
관교중학교(약수터),37203,10956,6641,10680,6641,276,586
관리공단본부,42720,757,94,750,94,7,28
관창마을,35252,1449,887,1407,887,42,77
관창마을,35253,1757,1970,1712,1970,45,124
광명아파트,37434,14306,6932,14227,6932,79,707
광명아파트,39348,7585,14252,7532,14252,53,727
광명아파트,39835,16,887,11,887,5,30
광명아파트,40590,2666,956,2617,956,49,120
광명아파트,40817,7301,1514,7208,1514,93,293
광명아파트,41096,468,2476,437,2476,31,98
광명아파트,41098,2594,786,2534,786,60,112
광명아파트,41108,14721,20706,14563,20706,158,1180
광명아파트,41448,2608,7987,2527,7987,81,353
광명역IC진입(미정차),53043,1,0,1,0,0,0
광명역IC출입(미정차),53042,2,0,2,0,0,0
광명항,35708,135,7,135,7,0,4
광명항,35714,1959,1765,1946,1765,13,124
광성보,43674,41,92,41,92,0,4
광성오리,43128,7,1,7,1,0,0
광성오리,43862,7,35,7,35,0,1
광일아파트,40855,3520,1015,3411,1015,109,151
광일아파트,40874,1559,3020,1519,3020,40,152
교대역,31013,25697,24355,25666,24355,31,1668
교대입구,41141,2116,2941,2068,2941,48,168
교대입구,41142,2921,2187,2832,2187,89,170
교대후문,41362,1229,255,1217,255,12,49
교대후문,41363,219,2638,215,2638,4,95
교동중고후문,90024,13,88,8,88,5,3
교동중고후문,90025,135,8,122,8,13,4
교보생명,37357,21295,78229,21095,78229,200,3317
교산교회,43496,53,9,43,9,10,2
교산교회,43719,14,11,10,11,4,0
교산리입구,43694,33,35,19,35,14,2
교산리입구,43748,34,30,25,30,9,2
교산상회앞,43494,0,1,0,1,0,0
교산상회앞,43715,1,4,1,4,0,0
교육개발원입구,31005,1044,8,1042,8,2,35
교육개발원입구,31006,43,1001,43,1001,0,34
교통방송사거리,37538,783,2245,716,2245,67,100
교통방송사거리,37539,1027,1603,1001,1603,26,87
교통연수원,41191,525,2010,475,2010,50,84
교통연수원,41192,1535,1046,1499,1046,36,86
교회앞,43216,6,6,6,6,0,0
교회앞,43309,13,6,13,6,0,0
교회앞,43430,19,18,16,18,3,1
교회앞,43818,30,34,29,34,1,2
교회앞,90338,2,24,2,24,0,0
교회앞,90348,12,1,11,1,1,0
구검문소,43196,1,80,0,80,1,2
구검문소,43622,147,0,143,0,4,4
구능재,90193,24,3,18,3,6,0
구능재,90194,7,26,7,26,0,1
구도일주유소,40902,112,1455,107,1455,5,52
구두물입구,35219,382,277,381,277,1,21
구래리,80006,311,1389,302,1389,9,56
구래리,80007,1468,357,1454,357,14,60
구래역,80337,8230,14709,8109,14709,121,764
구래역,80338,17831,8790,17421,8790,410,887
구렁목,43950,161,10,151,10,10,5
구렁목,43951,7,94,6,94,1,3
구름다리,35735,9,83,9,83,0,3
구름다리,35736,32,5,32,5,0,1
구면사무소,43823,0,1,0,1,0,0
구반포역.세화고등학교,31031,1549,19,1549,19,0,52
구봉도입구,62035,29,375,27,375,2,13
구봉도입구,62037,376,26,372,26,4,13
구북성초교,43506,2,0,2,0,0,0
구북성초교,43656,6,9,6,9,0,0
구산사거리,40233,737,469,734,469,3,40
구산사거리,40842,517,19558,429,19558,88,669
구산사거리,40843,3361,7083,3219,7083,142,348
구산중학교,40518,637,823,624,823,13,48
구선택초교,43239,1,0,1,0,0,0
구선택초교,43896,0,3,0,3,0,0
구월1동행정복지센터,39967,860,2,860,2,0,28
구월1동행정복지센터,39981,1,451,0,451,1,15
구월2동행정복지센터,39586,3986,383,3972,383,14,145
구월2동행정복지센터,39607,418,3359,413,3359,5,125
구월도매전통시장,39192,17327,14685,16900,14685,427,1067
구월도매전통시장,39193,18186,28422,17997,28422,189,1553
구월동로데오거리,39195,4640,1044,4564,1044,76,189
구월동우체국,39211,3988,13027,3896,13027,92,567
구월동팬더아파트,39237,9136,8663,8980,8663,156,593
구월동팬더아파트,39238,9998,7061,9766,7061,232,568
구월서초등학교,39204,6880,5941,6726,5941,154,427
구월서초등학교,39205,5837,6076,5740,6076,97,397
구월아시아드1단지,39912,604,83,578,83,26,22
구월아시아드1단지,39913,9,107,1,107,8,3
구월아시아드5단지정문,39883,2592,5909,2550,5909,42,283
구월아시아드5단지후문,39881,2376,4390,2340,4390,36,225
구월아시아드6단지,39885,21885,8027,21534,8027,351,997
구월아시아드6단지,39886,7171,15426,7045,15426,126,753
구월아시아드7단지,39892,1465,2049,1442,2049,23,117
구월아시아드8단지,39891,2653,1183,2620,1183,33,127
구월아시아드8단지,39948,58,502,57,502,1,18
구월아시아드8단지,39949,85,250,72,250,13,11
구월아시아드선수촌센트럴자이,39884,3388,2347,3333,2347,55,191
구월아시아드선수촌아파트,39202,1125,825,1124,825,1,65
구월아시아드선수촌아파트,39203,737,1989,724,1989,13,90
구월아시아드은빛호수공원,39914,10084,5379,9876,5379,208,515
구월아시아드은빛호수공원,39915,6583,6081,6392,6081,191,422
구월우체국,39213,9685,7075,9471,7075,214,558
구월중학교,39281,26977,18703,26382,18703,595,1522
구월중학교,39286,18933,29380,18533,29380,400,1610
구월체육공원,39384,3299,4710,3244,4710,55,266
구월초등학교,39832,1998,4145,1954,4145,44,204
구월초등학교,39833,3962,2372,3859,2372,103,211
구월한내들퍼스티지,39882,4169,1741,4097,1741,72,197
구장수파출소,39375,756,562,734,562,22,43
구재이,43282,47,17,41,17,6,2
구재이,43551,8,18,8,18,0,0
구정슈퍼앞,35498,8,39,8,39,0,1
구정슈퍼앞,35587,81,16,74,16,7,3
구정정미소,90284,5,28,5,28,0,1
구정정미소,90306,20,0,20,0,0,0
구중학교앞,44119,1,11,1,11,0,0
구중학교앞,44148,5,2,4,2,1,0
구하1리입구,43259,0,35,0,35,0,1
구하1리입구,43562,81,1,68,1,13,2
구하2리마을회관,43254,86,1,84,1,2,2
구하2리마을회관,43256,56,2,56,2,0,1
구하2리마을회관,43373,0,62,0,62,0,2
구하2리마을회관,43559,1,53,1,53,0,1
국궁장앞,70151,42,216,42,216,0,8
국립생물자원관,89111,197,416,193,416,4,20
국립생물자원관입구,42741,279,473,261,473,18,25
국립인천공항검역소,35430,12,387,10,387,2,13
국립인천공항검역소,35431,117,103,116,103,1,7
국민건강보험 인천부평지사,40620,1181,4269,1168,4269,13,181
국민건강보험 인천부평지사,40621,3650,1442,3605,1442,45,169
국민건강보험남부지사,37274,8821,9964,8631,9964,190,626
국민은행,38148,1973,4943,1953,4943,20,230
국민은행,38149,4982,2183,4869,2183,113,238
국민은행연수중앙지점,38129,6449,4526,6298,4526,151,365
국민은행연수중앙지점,38571,2097,4239,2077,4239,20,211
국제금융단지,89292,7149,5669,7069,5669,80,427
국제금융단지,89293,2896,4989,2892,4989,4,262
국제성모병원,89030,385,1362,379,1362,6,58
국제성모병원,89031,2428,1039,2406,1039,22,115
국제성모병원(종점),89369,0,110,0,110,0,3
국제업무단지(공항청사),35026,14246,2574,13962,2574,284,560
국제업무지구역,38528,1353,3255,1341,3255,12,153
국제업무지구역5번출구,38619,2287,1775,2271,1775,16,135
국제이노베이션,37573,8,1368,5,1368,3,45
국제이노베이션,37574,1454,10,1446,10,8,48
국제콘크리트,90050,58,31,58,31,0,2
국제콘크리트,90051,28,131,27,131,1,5
국제학교,38457,2300,527,2238,527,62,94
국제학교,38462,986,2384,946,2384,40,112
국촌,43251,135,1,121,1,14,4
국촌,43371,1,81,1,81,0,2
국화리야영장앞,43353,34,2,33,2,1,1
국화리야영장앞,43843,1,63,1,63,0,2
국화맨션,43359,0,2,0,2,0,0
국화맨션,43566,32,7,32,7,0,1
국회연수원입구,43919,3,0,3,0,0,0
국회연수원입구,43920,0,26,0,26,0,0
군인아파트,43046,115,57,106,57,9,5
군인아파트,43047,45,124,44,124,1,5
굴다리,37142,7804,96,7745,96,59,263
굴다리오거리,40231,19525,8251,19122,8251,403,925
굴다리오거리,40232,15416,23240,15238,23240,178,1288
굴다리입구,37152,7104,3626,6836,3626,268,357
굴포천,40506,2362,2250,2298,2250,64,153
굴포천,40509,2413,3568,2348,3568,65,199
굴포천역(롯데마트),40814,42907,25492,42526,25492,381,2279
굴포천역(롯데마트),40815,18619,22584,18458,22584,161,1373
굴포천역(부평농협),40507,6447,8435,6420,8435,27,496
굴포천역(부평농협),40508,9597,6257,9484,6257,113,528
굴포천역(신복사거리),40485,4371,19030,4316,19030,55,780
굴포천역(신복사거리),40498,29777,7393,29522,7393,255,1239
굴포천역(욱일아파트),40519,4708,12549,4671,12549,37,575
굴포천역(욱일아파트),40522,7156,3078,7101,3078,55,341
궁골,43346,2,15,2,15,0,0
궁골,43572,16,1,16,1,0,0
궁현사거리,37575,3,887,2,887,1,29
궁현사거리,37576,434,15,430,15,4,14
귀뚜라미보일러,42003,9,206,4,206,5,7
귀뚜라미보일러,42004,219,0,219,0,0,7
귤현감리교회,41385,1991,5317,1941,5317,50,243
귤현감리교회,41386,4484,3156,4425,3156,59,254
귤현동마을입구,41326,560,132,547,132,13,23
귤현동마을입구,41328,103,597,102,597,1,23
귤현아이파크정문,41572,2187,500,2185,500,2,89
귤현역,41331,5986,4369,5972,4369,14,345
귤현역,41332,1787,915,1765,915,22,90
귤현차량기지(센트레빌3단지),41443,2820,827,2776,827,44,121
귤현차량기지(센트레빌3단지),41444,1265,3629,1243,3629,22,163
귤현차량기지(안골공원),41618,1295,1836,1287,1836,8,104
귤현차량기지(안골공원),41619,145,583,139,583,6,24
귤현현대아이파크,41620,635,1872,634,1872,1,83
그린나래지하차도,35648,2,385,2,385,0,12
그린나래지하차도,35649,2243,700,2218,700,25,98
그린빌라,42222,2090,1334,2018,1334,72,114
그린빌라,42602,1295,3097,1275,3097,20,146
그린힐아파트.e편한세상아파트,40194,307,1823,295,1823,12,71
극동.금호아파트,39272,4975,7276,4837,7276,138,408
극동.금호아파트,39278,6361,5415,6279,5415,82,392
극지연구소,39918,2692,2767,2639,2767,53,181
극지연구소,39919,4105,2854,4091,2854,14,231
근대문화거리입구,35369,2335,3992,2262,3992,73,210
근대문화거리입구,35370,3051,1870,2957,1870,94,164
근로복지공단인천병원,40145,10769,12771,10674,12771,95,784
근로복지공단인천병원,40155,20623,10300,20511,10300,112,1030
글로벌캠퍼스푸르지오,39841,2700,7784,2617,7784,83,349
글로벌파크,39975,479,912,474,912,5,46
글로벌파크,39976,119,1489,112,1489,7,53
글로벌파크베르디움,39840,6976,1758,6895,1758,81,291
금강다이아몬드,39007,563,1678,546,1678,17,74
금강다이아몬드,39008,960,433,949,433,11,46
금강마을,55066,1648,2412,1585,2412,63,135
금강마을,55068,4642,774,4615,774,27,180
금강요양병원,37291,8922,6032,8721,6032,201,498
금강종합상가,42858,897,47,885,47,12,31
금강찜질방,44113,25,17,21,17,4,1
금강찜질방,44149,18,9,17,9,1,0
금강찜질방,44150,25,16,16,16,9,1
금강찜질방,44151,6,6,5,6,1,0
금강탱크터미널,42758,1116,2303,1096,2303,20,113
금강펜테리움더시글로,89392,9027,2047,8988,2047,39,369
금강펜테리움더시글로,89459,225,1553,212,1553,13,59
금곡교차로,89370,13,37,13,37,0,1
금곡동,42471,3,240,3,240,0,8
금곡동,42587,552,56,552,56,0,20
금곡종점,89319,126,119,108,119,18,8
금란마트,89056,82,1063,72,1063,10,38
금란마트,89061,18,601,4,601,14,20
금마초등학교,40833,7213,4174,6640,4174,573,379
금산경로당,35564,3,163,3,163,0,5
금산경로당,35565,13,5,13,5,0,0
금성목재,42812,0,177,0,177,0,5
금운교,43298,1,32,1,32,0,1
금운교,43858,5,37,5,37,0,1
금월리종점,43777,108,69,95,69,13,5
금정골입구,90301,2,2,2,2,0,0
금정부락,90300,4,1,4,1,0,0
금호2차아파트,37031,6781,1259,6662,1259,119,268
금호2차아파트,37033,1963,4047,1908,4047,55,200
금호베스트빌1단지.영종도서관,35112,1376,2159,1349,2159,27,117
금호베스트빌1단지.영종도서관,35113,3562,1331,3506,1331,56,163
금호아파트,37061,178,537,175,537,3,23
금호아파트,38302,641,839,637,839,4,49
금호아파트,38349,11057,2726,10854,2726,203,459
금호아파트,40441,3589,1169,3530,1169,59,158
금호아파트,40795,19937,19248,19768,19248,169,1306
금호아파트,40845,6860,7823,6757,7823,103,489
금호어울림,35313,2944,1152,2872,1152,72,136
금호어울림,35384,775,2842,742,2842,33,120
금호어울림,37048,1298,1952,1227,1952,71,108
금호어울림2차,35597,11,1,11,1,0,0
금호어울림2차,35598,0,18,0,18,0,0
금호어울림아파트,42137,3708,2462,3673,2462,35,205
금호어울림아파트,42139,2583,2764,2555,2764,28,178
금호어울림아파트,42592,254,1030,246,1030,8,42
금호어울림아파트,42593,1052,843,1025,843,27,63
금호이수마운트밸리,40316,380,889,367,889,13,42
금호종합열처리,42801,671,138,668,138,3,26
금호타운,37024,14370,3612,14046,3612,324,599
금호타운,37026,4706,14985,4645,14985,61,656
금홍염전,35543,348,237,338,237,10,19
금홍염전,35544,378,2860,361,2860,17,107
기계공고,37294,5029,3059,4880,3059,149,269
기계철제단지,36129,7,216,7,216,0,7
기계철제단지,36149,186,44,186,44,0,7
기신정기,39567,799,1468,797,1468,2,75
기업은행(구월동지점),39178,249,573,239,573,10,27
기업은행앞,70152,209,35,206,35,3,8
긴마루교회입구,35686,63,32,63,32,0,3
긴마루교회입구,35692,17,22,16,22,1,1
길병원,39250,81001,82273,80131,82273,870,5442
길병원,39262,14573,11489,14376,11489,197,868
길병원,39264,6523,9543,6436,9543,87,535
길병원,39590,77818,69225,77101,69225,717,4901
길병원사거리,39212,20292,19510,19897,19510,395,1326
길병원사거리,39216,21197,24725,20710,24725,487,1530
길상교회,43148,31,2,27,2,4,1
길상교회,43701,1,38,0,38,1,1
길상군립어린이집,43959,100,27,100,27,0,4
길상군립어린이집,43960,28,118,25,118,3,4
길상낚시터,43149,5,13,5,13,0,0
길상낚시터,43883,3,12,3,12,0,0
길상보건지소,43021,220,560,198,560,22,26
길상보건지소,43069,359,358,317,358,42,23
길정저수지,90054,4,2,4,2,0,0
길정저수지,90055,2,3,2,3,0,0
길주초등학교,41654,68,31,66,31,2,3
길직1리,43270,84,159,81,159,3,8
길직리,43031,172,145,164,145,8,10
길직리입구,43304,2,69,2,69,0,2
길직리입구,43313,29,16,29,16,0,1
길훈4차아파트,80040,8,245,8,245,0,8
길훈4차아파트,80041,231,1,228,1,3,7
길훈아파트,42494,8211,8553,8136,8553,75,558
김미현골프장,39749,1201,786,1183,786,18,66
김미현골프장,39751,704,1487,703,1487,1,73
김소골,35675,21,23,21,23,0,1
김소골,35703,39,20,39,20,0,1
김지곡,43455,0,44,0,44,0,1
김지곡,43831,82,0,63,0,19,2
김포공항국내선,25029,2922,3098,2837,3098,85,200
김포공항국내선,25091,595,133,585,133,10,24
김포공항국제선,25006,1073,4318,1068,4318,5,179
김포공항국제선,25164,81,204,73,204,8,9
김포대학입구,80257,611,40,603,40,8,21
김포대학입구,80258,42,602,40,602,2,21
김포초교,80028,134,716,132,716,2,28
김포초교,80030,758,125,758,125,0,29
김포한강신협,80032,958,707,943,707,15,55
김포한강신협,80035,936,1161,924,1161,12,69
까치공원.작전도서관,41149,14163,11736,13978,11736,185,863
까치말사거리,41563,8347,2871,8317,2871,30,373
까치말사거리,41564,2700,7163,2677,7163,23,328
꿈동산.사랑마을,55022,1339,2039,1338,2039,1,112
꿈동산.사랑마을,55024,1406,125,1394,125,12,51
꿈에그린아파트,92023,3893,4674,3796,4674,97,285
나누리병원,40398,29391,20234,28960,20234,431,1654
나누리병원,40784,24363,20342,24104,20342,259,1490
나래병원,38142,2670,1873,2628,1873,42,151
나룻개,35593,43,243,41,243,2,9
나룻개,35594,208,41,196,41,12,8
나룻개입구,35385,18,278,18,278,0,9
나룻개입구,35386,256,10,251,10,5,8
나무깨,90184,5,14,5,14,0,0
나무다리,90340,0,17,0,17,0,0
나무다리,90344,22,2,22,2,0,0
나사렛국제병원앞,38068,49733,15207,48553,15207,1180,2164
나은병원,42056,6856,2056,6768,2056,88,297
낚시터매점,43356,4,20,4,20,0,0
낚시터매점,43840,25,0,25,0,0,0
낚시터입구,42802,100,720,100,720,0,27
난곳정미소,90286,53,53,53,53,0,3
난정1리마을회관,90285,32,15,32,15,0,1
난정1리마을회관,90287,6,0,6,0,0,0
난정보건진료소앞,90289,2,3,2,3,0,0
난정초등학교입구,90305,8,0,8,0,0,0
남광로얄아파트,37257,20317,27562,19881,27562,436,1595
남광하우스토리,42841,3605,763,3521,763,84,145
남광하우스토리,42920,4943,1448,4811,1448,132,213
남광하우스토리,42921,1621,4073,1569,4073,52,189
남동I.C(문학동입구),39168,304,4686,281,4686,23,166
남동경기장,92055,222,97,220,97,2,10
남동경찰서·남촌농산물도매시장,39147,3499,1857,3468,1857,31,178
남동경찰서·남촌농산물도매시장,39148,2379,1625,2298,1625,81,133
남동고등학교,92035,181,176,177,176,4,11
남동고등학교,92036,25,84,24,84,1,3
남동공단2호공원,39075,760,5547,726,5547,34,210
남동공단근린공원앞,39073,4895,871,4875,871,20,192
남동공단우체국,39076,1929,5996,1921,5996,8,264
남동구청,39263,11597,7646,11523,7646,74,641
남동구청,39279,10952,14347,10803,14347,149,843
남동구청역,39318,12445,8114,12326,8114,119,685
남동구청역,39324,13393,15226,13173,15226,220,953
남동구청후문(남동등기소),39287,6161,11000,6057,11000,104,572
남동구청후문(남동등기소),39288,5305,3184,5160,3184,145,282
남동국가산업단지 입구,39853,692,14,638,14,54,23
남동국가산업단지(기신정기),39568,1554,1279,1538,1279,16,94
남동대교,38090,2238,7230,2161,7230,77,315
남동대교(스퀘어원),39063,5219,3073,5008,3073,211,276
남동빌라,39330,5018,1933,4909,1933,109,231
남동세무서,39887,22883,12211,22629,12211,254,1169
남동세무서,39888,14262,23285,14043,23285,219,1251
남동소래아트홀,39743,441,108,439,108,2,18
남동소래아트홀,39744,363,62,363,62,0,14
남동소래아트홀,39748,127,268,127,268,0,13
남동소래아트홀,39792,101,347,101,347,0,14
남동소방서,39252,1124,2597,1109,2597,15,124
남동소방서,39587,11210,7114,10952,7114,258,610
남동시범공단앞,39100,3535,5725,3517,5725,18,308
남동시범공단앞,39102,6721,2850,6661,2850,60,319
남동아시아드럭비경기장,39214,351,925,338,925,13,42
남동아시아드럭비경기장,39215,458,697,407,697,51,38
남동인더스파크역,39074,12849,2035,12753,2035,96,496
남동인더스파크역1번출구,92045,130,0,129,0,1,4
남동인더스파크역1번출구,92050,2,93,2,93,0,3
남동정수장,39372,324,786,308,786,16,37
남동중학교,39220,11358,6581,11200,6581,158,597
남동중학교,39224,6306,5465,6207,5465,99,392
남동체육관,39930,827,917,810,917,17,58
남동체육관,39947,865,1679,849,1679,16,84
남동체육관(체조경기장),39682,1986,2901,1935,2901,51,162
남동체육관(체조경기장),39862,1160,1020,1149,1020,11,72
남동초등학교,39254,17784,27913,17705,27913,79,1523
남동초등학교,39255,32795,15424,32332,15424,463,1607
남동초등학교,39265,4891,602,4787,602,104,183
남동화원,39300,7580,6259,7528,6259,52,461
남디4거리,35271,219,848,198,848,21,35
남디4거리,35280,365,406,344,406,21,25
남부고가교,40921,9,195,7,195,2,6
남산리,43324,3,0,3,0,0,0
남산리,43628,16,6,16,6,0,0
남산유스호스텔,43982,19,0,19,0,0,0
남산유스호스텔,43985,2,15,2,15,0,0
남산포입구,90030,4,53,4,53,0,1
남산포입구,90031,62,0,53,0,9,2
남성네고개,35426,13,191,11,191,2,6
남성네고개,35427,68,4,68,4,0,2
남씨농원앞,41495,23,110,23,110,0,4
남씨농원앞,41511,56,2,55,2,1,1
남양목재,42814,1,195,1,195,0,6
남인천농협백운지점,37174,209,977,207,977,2,39
남인천새마을금고중앙지점,37300,16388,14564,16012,14564,376,1031
남인천여자중학교,39190,19250,6182,18632,6182,618,847
남인천여자중학교,39191,8133,17901,7941,17901,192,867
남중학교,37331,7169,598,7023,598,146,258
남중학교,37336,5806,16137,5682,16137,124,731
남청라TG,89379,97,2,88,2,9,3
남청라TG,89380,4,68,4,68,0,2
남촌농산물도매시장,92031,6686,209,6515,209,171,229
남촌농산물도매시장,92032,82,4310,40,4310,42,146
남촌농산물도매시장채소동앞,92033,52,1571,43,1571,9,54
남촌농산물도매시장채소동앞,92034,388,647,379,647,9,34
남촌동다목적센터,39908,69,1467,68,1467,1,51
남촌동다목적체육센터,39907,360,226,338,226,22,19
남촌동입구,39166,4070,9355,4020,9355,50,447
남촌입구,39156,272,626,248,626,24,29
남촌입구,39157,558,1730,524,1730,34,76
남촌풍림2차아파트,39171,6348,11139,6254,11139,94,582
남촌풍림3차아파트,39165,4598,4376,4504,4376,94,299
남촌풍림3차아파트,39167,4190,4744,3982,4744,208,297
남촌풍림아파트,39172,12746,3502,12514,3502,232,541
남항유어선부두,35078,5201,1608,4869,1608,332,226
남항유어선부두,35079,201,4396,143,4396,58,153
납섬입구,90185,18,3,15,3,3,0
납섬입구,90186,3,12,3,12,0,0
내2리마을회관앞,44138,88,30,85,30,3,3
내2리마을회관앞,44152,9,16,9,16,0,0
내3리다목적회관앞,44121,0,5,0,5,0,0
내3리다목적회관앞,44153,3,1,3,1,0,0
내3리마을회관,44154,9,0,9,0,0,0
내3리마을회관,44155,14,3,14,3,0,0
내3리마을회관,44156,7,21,3,21,4,0
내4리마을회관,44104,21,67,16,67,5,2
내4리마을회관,44157,57,5,49,5,8,2
내7리마을회관,44118,0,5,0,5,0,0
내7리마을회관,44159,13,14,4,14,9,0
내가면사무소(맞은편),43906,110,65,104,65,6,5
내가면사무소(사무소),43907,69,137,68,137,1,6
내가시장,43392,158,318,153,318,5,15
내가시장,43484,502,217,439,217,63,23
내가초등학교,43368,113,41,100,41,13,5
내가초등학교,43554,51,132,49,132,2,6
내건너,90167,35,45,35,45,0,2
내건너,90168,31,29,31,29,0,2
내동교회,44114,6,12,5,12,1,0
내리교회,43395,19,6,19,6,0,0
내리교회,43543,13,33,13,33,0,1
내리쉼터,43968,0,5,0,5,0,0
내리쉼터,43972,5,0,5,0,0,0
내리어촌계사무실,44135,1,1,1,1,0,0
내리주유소.한국화장품삼거리,57016,1574,1559,1565,1559,9,104
내리주유소.한국화장품삼거리,57018,2199,2213,2192,2213,7,147
내촌,43343,63,43,63,43,0,3
내촌,43581,62,16,60,16,2,2
내촌입구,90394,0,21,0,21,0,0
내촌입구,90395,0,1,0,1,0,0
너출(드무리입구),44086,1,2,1,2,0,0
너출(드무리입구),44161,5,4,5,4,0,0
넘말,43140,0,2,0,2,0,0
넘말,43438,0,2,0,2,0,0
넙디,35574,1567,5769,1483,5769,84,244
넙디,35575,7850,1299,7742,1299,108,304
넙디마을입구,35389,81,104,78,104,3,6
노랑새고개,43273,124,37,121,37,3,5
노랑새고개,43570,40,139,34,139,6,5
노인복지회관,37599,130,758,128,758,2,29
노인인력개발센터,40134,1188,226,1088,226,100,47
노인인력개발센터,40745,178,1113,160,1113,18,43
녹청자박물관,42668,2707,507,2642,507,65,107
녹청자박물관,42669,172,2137,172,2137,0,76
논고개길,39687,2000,2710,1943,2710,57,157
논고개길,39819,2252,2025,2225,2025,27,142
논고개길사거리,39870,575,6,565,6,10,19
논골,35318,14,12,14,12,0,0
논골,35394,39,22,37,22,2,2
논골,44098,0,1,0,1,0,0
논골,44163,0,30,0,30,0,1
논골경로당 입구,35770,10,3,10,3,0,0
논골경로당 입구,35771,4,31,4,31,0,1
논현10단지별빛마을웰카운티A정문,39121,5736,2674,5655,2674,81,280
논현10단지별빛마을웰카운티A후문,39599,849,1544,795,1544,54,79
논현12단지산뒤마을,39609,5670,12213,5635,12213,35,596
논현13단지푸르네마을,39611,4033,6836,3983,6836,50,362
논현13단지푸르네마을,39617,4931,2114,4900,2114,31,234
논현13단지푸르네마을,39618,1463,2592,1442,2592,21,135
논현14단지등대마을,39610,10203,1506,9974,1506,229,390
논현14단지등대마을휴먼시아아파트,39612,9073,4263,8870,4263,203,444
논현1동행정복지센터,39598,1527,871,1493,871,34,79
논현2단지범마을,39625,3033,10705,2878,10705,155,457
논현2동행정복지센터,39571,1136,184,1122,184,14,44
논현2동행정복지센터,39572,132,1029,126,1029,6,38
논현2동행정복지센터,39636,1235,3279,1190,3279,45,150
논현2동행정복지센터,39697,3088,1379,3034,1379,54,148
논현3단지하늘마을301동,39631,102,3277,80,3277,22,112
논현3단지하늘마을302동,39624,17776,5322,17522,5322,254,769
논현3단지하늘마을305동,39626,2310,5974,2277,5974,33,276
논현3단지하늘마을305동,39627,4428,2523,4389,2523,39,231
논현5단지달맞이마을,39079,9910,3416,9458,3416,452,444
논현6단지어진마을한화꿈에그린A정문,39078,3584,6874,3470,6874,114,348
논현8단지동산마을,39104,4674,2073,4622,2073,52,224
논현8단지동산마을,39569,712,777,712,777,0,49
논현8단지동산마을,39570,611,702,586,702,25,43
논현9단지냇마을신영지웰A,39101,2230,3643,2202,3643,28,195
논현9단지냇마을신영지웰A,39602,342,223,325,223,17,18
논현9단지냇마을신영지웰A,39603,27,705,23,705,4,24
논현9단지냇마을신영지웰A정문,39600,2244,989,2168,989,76,107
논현고잔동행정복지센터,39707,7868,13554,7654,13554,214,714
논현단풍마을트리플에듀,39582,3724,5754,3665,5754,59,315
논현단풍마을트리플에듀,39616,433,212,433,212,0,21
논현동힐스테이트,39708,20860,9658,20480,9658,380,1017
논현사거리,39504,5464,4322,5371,4322,93,326
논현사거리,39505,4267,4517,4199,4517,68,292
논현센트럴뷰·에코메트로5단지,39693,758,868,700,868,58,54
논현신일해피트리아파트,39088,2291,7254,2228,7254,63,318
논현신일해피트리아파트,39089,7051,2840,6882,2840,169,329
논현역,32007,60,3748,60,3748,0,126
논현역,32008,4267,54,4259,54,8,144
논현유승한내들,39839,1428,2854,1422,2854,6,142
논현유승한내들,39923,3117,969,3045,969,72,136
논현주공1단지,39112,15192,7606,15023,7606,169,759
논현주공2단지,39106,12562,13559,12347,13559,215,870
논현주공아파트(인천금융고),39096,13273,10959,13038,10959,235,807
논현주공아파트(인천금융고),39098,16022,13420,15832,13420,190,981
논현중앙공원·남동논현도서관,39604,411,1851,407,1851,4,75
논현중학교,39573,1564,264,1546,264,18,60
논현중학교,39574,96,924,96,924,0,34
논현초등학교,39601,743,1952,716,1952,27,89
논현파크포레,39649,5969,3464,5733,3464,236,314
논현파크포레,39722,1484,3696,1407,3696,77,172
논현포대근린공원,92056,59,37,59,37,0,3
논현푸르지오.유호엔시티,39822,2600,119,2549,119,51,90
논현화훼단지,39830,154,1363,150,1363,4,50
논현화훼단지,39831,275,784,263,784,12,35
농기계은행앞,90036,0,30,0,30,0,1
농기계은행앞,90037,30,0,30,0,0,1
농도원,43178,41,67,37,67,4,3
농도원,43355,139,49,134,49,5,6
농막골,90189,3,0,3,0,0,0
농막골,90190,5,3,1,3,4,0
농산물시장,40688,3477,1395,3400,1395,77,162
농어바위캠핑장,44140,5,6,4,6,1,0
농어바위캠핑장,44164,34,26,33,26,1,2
농어촌공사앞,43268,138,7,127,7,11,4
농어촌공사앞,43489,14,101,10,101,4,3
농업기술센터,43357,231,116,218,116,13,11
농업기술센터,43573,64,199,61,199,3,8
농장주유소,39472,328,1027,326,1027,2,45
농장주유소,39508,177,702,177,702,0,29
농협로타리,40244,1186,2865,1167,2865,19,135
농협로타리,40248,2626,1287,2539,1287,87,130
농협로타리,40251,1187,2664,1166,2664,21,128
농협로타리,40751,4125,2814,4073,2814,52,231
농협하나로마트,44117,2,0,1,0,1,0
농협하나로마트,44165,1,1,1,1,0,0
높은마을입구,35685,59,26,59,26,0,2
높은마을입구,35693,64,54,61,54,3,3
누촌,43238,30,82,25,82,5,3
누촌,43360,101,25,71,25,30,4
뉴그린아트빌,40875,952,867,923,867,29,60
뉴그린아트빌,40876,497,1621,487,1621,10,70
뉴서울1차아파트,40275,13618,62,13387,62,231,456
뉴서울3차아파트,41026,1820,4049,1785,4049,35,195
뉴서울3차아파트,41029,8961,1457,8848,1457,113,347
뉴서울3차아파트,41032,1672,5138,1620,5138,52,227
뉴서울6차아파트,41632,1623,408,1588,408,35,67
뉴서울6차아파트,41635,510,1738,501,1738,9,74
뉴서울아파트,38303,1366,1568,1362,1568,4,97
뉴서울아파트,39234,9232,191,9125,191,107,314
뉴서울아파트,39235,225,5038,216,5038,9,175
뉴서울아파트,40505,2351,936,2278,936,73,109
뉴서울아파트,40514,697,466,670,466,27,38
뉴서울아파트,40526,2552,4228,2521,4228,31,226
뉴서울아파트,41153,4849,5698,4814,5698,35,351
뉴서울아파트,89071,7130,18568,6839,18568,291,856
느티나무,43182,7,92,6,92,1,3
느티나무,43232,68,4,63,4,5,2
늘목,35414,95,479,95,479,0,19
늘목,35415,323,69,319,69,4,13
늘목마을입구,35529,5,35,5,35,0,1
늘목마을입구,35725,41,7,41,7,0,1
늘푸른벽산.서강2차,70021,78,2482,16,2482,62,85
능곡마을회관,43553,105,13,85,13,20,3
능곡마을회관,43649,24,46,24,46,0,2
능미,43921,51,2,50,2,1,1
능미,43922,1,72,1,72,0,2
능안,43276,88,64,88,64,0,5
능안,43571,21,55,19,55,2,2
능촌삼거리,90370,0,3,0,3,0,0
능촌입구,43560,13,5,13,5,0,0
능촌입구,43854,0,20,0,20,0,0
능허대공원,38567,294,755,291,755,3,34
다남동소촌마을입구,41329,614,5,608,5,6,20
다남동소촌마을입구,41330,1,602,1,602,0,20
다남동역골입구,41333,8,196,8,196,0,6
다남동역골입구,41334,70,247,69,247,1,10
다남성결교회,41664,9,9,9,9,0,0
다남식당,41477,2142,11611,2093,11611,49,458
다남식당,41478,634,3466,605,3466,29,136
다리목,43717,4,8,3,8,1,0
다리목,43845,10,8,10,8,0,0
다우리농장,44083,4,0,4,0,0,0
다우리농장,44166,0,1,0,1,0,0
다운,43605,79,79,70,79,9,5
다운,43822,121,62,117,62,4,6
다운1리,43582,23,47,23,47,0,2
다운1리,43821,28,24,26,24,2,1
다운마을,43398,6,75,6,75,0,2
다운마을,43824,101,0,98,0,3,3
다임메가타운,40870,79,550,75,550,4,20
단봉초등학교,42380,3286,620,3223,620,63,130
단봉초등학교,42382,784,2800,749,2800,35,119
달빛축제공원,38620,20,64,19,64,1,2
달빛축제공원,38621,29,445,26,445,3,15
달빛축제공원대공연장,38733,211,503,211,503,0,23
달빛축제공원대공연장,38734,903,244,892,244,11,38
담방로사거리,39275,12048,4111,11863,4111,185,538
담방아파트,39226,589,71,583,71,6,22
당곡고개,80048,90,521,90,521,0,20
당곡고개,80049,536,28,528,28,8,18
당미마을,41552,4508,6278,4481,6278,27,359
당미마을,41553,4567,3499,4498,3499,69,268
당산리,43450,12,102,12,102,0,3
당산리,43700,122,3,118,3,4,4
당산리검문소,43699,148,32,139,32,9,6
당산리검문소,43752,26,133,26,133,0,5
당산종점,43669,2,22,2,22,0,0
당산종점,43725,32,2,30,2,2,1
당산초등학교,41418,6298,3333,6212,3333,86,321
당산초등학교,41419,2483,3359,2450,3359,33,194
당산초등학교아래사거리,41644,63,171,59,171,4,7
당산초등학교아래사거리,41645,598,372,598,372,0,32
당하금호어울림1차,42435,188,410,177,410,11,19
당하농원,42388,10,13,10,13,0,0
당하농원,42390,4,50,3,50,1,1
당하대주파크빌,42392,1720,1179,1686,1179,34,96
당하동탑스빌아파트,42639,4454,3083,4354,3083,100,251
당하동행정복지센터,42886,8290,4512,8140,4512,150,426
당하마트,42618,14,30,14,30,0,1
당하마트,42619,3,122,3,122,0,4
당하메디칼,42402,1550,1868,1510,1868,40,113
당하초등학교,42396,1634,740,1594,740,40,79
당하초등학교,42399,1092,1455,1059,1455,33,84
당하탑스빌아파트,42393,2685,2767,2578,2767,107,181
당하푸르지오,42403,1252,843,1207,843,45,69
당하푸르지오,42502,248,1835,226,1835,22,69
당하풍림아파트,42405,2445,12514,2400,12514,45,498
대경화성,39789,1274,741,1273,741,1,67
대경화성,39790,924,1791,914,1791,10,90
대곶사거리,80008,1602,4860,1511,4860,91,215
대곶사거리,80009,5728,1328,5604,1328,124,235
대기이에스티,39013,287,292,286,292,1,19
대덕강업앞,42759,14,502,12,502,2,17
대동1차후문(종점),40553,326,721,321,721,5,34
대동도어(주),39983,438,40,436,40,2,15
대동도어(주),39984,4,584,4,584,0,19
대동아파트,37042,6708,2104,6626,2104,82,293
대동아파트,37504,3862,6184,3807,6184,55,334
대동아파트,38128,6567,10911,6454,10911,113,582
대동아파트,38345,5161,5592,5046,5592,115,358
대동아파트,39256,395,5469,383,5469,12,195
대동아파트,39473,4715,219,4666,219,49,164
대동아파트,39474,85,7941,79,7941,6,267
대동아파트,40491,775,282,749,282,26,35
대동아파트,40569,8607,3371,8332,3371,275,399
대동아파트,41172,2663,545,2605,545,58,106
대동아파트,42304,2629,4024,2575,4024,54,221
대동아파트,42306,2913,1887,2872,1887,41,160
대동아파트정문앞,40277,1518,866,1486,866,32,79
대동아파트후문,41137,2330,4554,2310,4554,20,229
대동월드,38116,5002,2668,4793,2668,209,255
대동특수철강,39049,134,1334,132,1334,2,48
대룡2리마을회관앞,90026,1,69,1,69,0,2
대룡2리마을회관앞,90027,92,4,85,4,7,3
대룡시장,90020,326,1495,320,1495,6,60
대룡시장,90021,1425,373,1369,373,56,59
대륭맨숀,40242,8695,5483,8572,5483,123,472
대륭맨숀,40247,9264,9951,9129,9951,135,640
대림3차아파트301동앞,38681,184,17,183,17,1,6
대림3차아파트301동앞,38684,24,685,23,685,1,23
대림아파트,37053,10181,3936,9946,3936,235,470
대림아파트,37054,2985,7362,2907,7362,78,344
대림아파트,38257,4774,1678,4717,1678,57,215
대림아파트,40382,3358,11386,3322,11386,36,491
대림아파트,42609,1786,1792,1601,1792,185,119
대림아파트,42610,255,1887,243,1887,12,71
대림아파트후문,40397,1786,1369,1736,1369,50,105
대림하이츠,37672,141,3,134,3,7,4
대명아파트,37537,2382,7043,2368,7043,14,314
대명초교,80002,1649,93,1607,93,42,58
대명초교,80003,238,1439,217,1439,21,55
대문리고개입구,43546,586,317,539,317,47,30
대문목재,89206,14,34,14,34,0,1
대문목재,89207,193,3,162,3,31,6
대문촌마을,90058,3,5,3,5,0,0
대문촌마을,90059,3,5,3,5,0,0
대박주유소,36091,2161,2323,2126,2323,35,149
대부고교차로,18388,0,7,0,7,0,0
대부관광호텔,62040,307,60,304,60,3,12
대부도서관,18389,2,31,2,31,0,1
대부도서관,18391,6,9,6,9,0,0
대부동행정복지센터,62011,366,1359,330,1359,36,57
대부동행정복지센터,62012,1564,245,1531,245,33,60
대부중고등학교,62027,438,94,431,94,7,17
대부중고등학교,62028,82,286,82,286,0,12
대부파출소앞,62036,9,145,9,145,0,5
대부파출소앞,62042,113,9,109,9,4,4
대사마을,43947,8,201,8,201,0,6
대사마을,43948,165,16,160,16,5,6
대산-기점,90259,1636,1580,1615,1580,21,107
대상스틸,89007,33,547,32,547,1,19
대성베르힐아파트(가정성당),89240,1550,2788,1507,2788,43,144
대성베르힐아파트(가정성당),89241,5235,2129,5192,2129,43,245
대성유니드아파트,40674,1051,3721,1025,3721,26,159
대성유니드아파트,40675,2155,335,2131,335,24,83
대신아파트,41406,5353,1977,5311,1977,42,244
대신철강,42859,14,1165,14,1165,0,39
대야초교.ABC학습타운입구,70017,238,1678,214,1678,24,63
대야초교.ABC학습타운입구,70020,1825,481,1788,481,37,76
대양자동차학원,35073,15,2418,15,2418,0,81
대우삼환아파트,38078,6722,4638,6558,4638,164,378
대우삼환아파트,38591,1331,3268,1291,3268,40,153
대우실업,41485,36,32,36,32,0,2
대우실업,41505,40,0,40,0,0,1
대우아파트,38206,4165,4202,4055,4202,110,278
대우아파트,38208,4308,2805,4206,2805,102,237
대우아파트,40321,215,398,207,398,8,20
대우아파트,40340,886,473,863,473,23,45
대우일렉트로닉스,37462,66,1576,55,1576,11,54
대우일렉트로닉스,37463,528,480,508,480,20,33
대우자동차운전학원,42262,267,233,257,233,10,16
대우자동차운전학원,42263,152,340,148,340,4,16
대우재아파트,39702,6,441,4,441,2,14
대우재아파트,39703,571,514,566,514,5,36
대우푸르지오,42407,24805,7072,24234,7072,571,1062
대우푸르지오,42842,943,4121,873,4121,70,168
대우푸르지오복합상가,39605,2812,1899,2686,1899,126,157
대우하나아파트,89073,17633,8814,17445,8814,188,881
대우하나아파트,89074,7184,10972,7076,10972,108,605
대웅실업앞,92003,41,292,41,292,0,11
대원레스피아1단지아파트,42643,7404,38,7228,38,176,248
대원정밀,39475,489,926,471,926,18,47
대월초등학교,90094,0,1,0,1,0,0
대월초등학교,90095,5,0,5,0,0,0
대은교회,42143,4500,9010,4329,9010,171,450
대인고등학교,42344,2496,2411,2447,2411,49,163
대인고등학교,42345,3484,1703,3385,1703,99,172
대일엠앤쿡,39059,971,2324,966,2324,5,109
대장간마을,43703,323,145,285,145,38,15
대정,90117,16,35,16,35,0,1
대정,90118,24,28,24,28,0,1
대주아파트,42469,2132,10785,1991,10785,141,430
대주파크빌,42466,5672,1485,5397,1485,275,238
대진아파트,40415,1735,2672,1728,2672,7,146
대촌,43393,45,34,43,34,2,2
대촌,43545,15,23,15,23,0,1
대촌마을,41663,15,2,15,2,0,0
대토단지앞,39813,1197,26,1165,26,32,40
대한솔루션알앤디센터,39557,47,170,47,170,0,7
대한제당,35169,1781,43,1767,43,14,60
대한제당,35220,37,1875,33,1875,4,63
대현목재,89205,314,37,311,37,3,11
대화초등학교,37397,6595,2713,6556,2713,39,310
대화초등학교,37399,3276,4800,3234,4800,42,269
대흥,43194,33,278,32,278,1,10
대흥,43591,317,17,304,17,13,11
대흥식당,35688,40,10,40,10,0,1
대흥식당,35689,13,47,13,47,0,2
더리미경로당,43363,25,13,23,13,2,1
더리미경로당,43731,17,11,17,11,0,0
더리미미술관,43961,49,26,36,26,13,2
더리미미술관,43962,22,6,8,6,14,0
더리미장어마을,43680,13,43,11,43,2,1
더리미장어마을,43864,30,9,27,9,3,1
더샵그린스퀘어105동,92021,1357,131,1322,131,35,49
더샵그린스퀘어107동,92022,110,1833,104,1833,6,64
더샵그린애비뉴,38486,6378,7915,6008,7915,370,476
더샵그린애비뉴,38510,754,830,713,830,41,52
더샵그린애비뉴,38511,1002,436,936,436,66,47
더샵그린워크1단지,38495,5593,2393,5475,2393,118,266
더샵부평센트럴시티(101동),40061,1050,2172,1046,2172,4,107
더샵부평센트럴시티(101동),40065,1951,943,1933,943,18,96
더샵부평센트럴시티(127동),40050,6382,8561,6296,8561,86,498
더샵센트럴시티204동,92020,91,1643,87,1643,4,57
더샵센트럴시티205동,92019,4255,2783,4184,2783,71,234
더샵송도프라임뷰20단지,38561,1265,2182,1175,2182,90,114
더샵엑스포빌리지,38480,8446,3318,8288,3318,158,392
더샵퍼스트파크13단지,38601,1091,209,1056,209,35,43
더샵퍼스트파크13단지,38602,178,599,165,599,13,25
더샵하버뷰,38485,9956,5440,9789,5440,167,513
더샵하버뷰,38487,3252,3063,3173,3063,79,210
더샵하버뷰(D13),38453,420,465,393,465,27,29
더샵하버뷰(D13),38466,813,752,798,752,15,52
더샵하버뷰(D14),38454,224,226,217,226,7,15
더샵하버뷰14단지,38504,1646,528,1628,528,18,72
더월드스테이트2단지,37657,736,466,705,466,31,40
더월드스테이트후문,37422,29,751,29,751,0,26
더포레스트아파트,39876,14515,1890,14499,1890,16,546
더포레스트아파트,39877,4610,11185,4579,11185,31,526
더프라우,38410,7906,21007,7577,21007,329,963
더필립요양병원,40461,2054,3952,2008,3952,46,200
덕고개삼거리,43723,56,34,55,34,1,3
덕고개삼거리,43750,1,30,1,30,0,1
덕골,43397,6,2,6,2,0,0
덕골,43399,1,9,1,9,0,0
덕교3거리,35012,99,48,94,48,5,4
덕교동,35003,737,247,732,247,5,32
덕교동,35005,236,1758,234,1758,2,66
덕교동,35259,967,174,961,174,6,38
덕교삼거리,35214,59,242,59,242,0,10
덕신고등학교(강화읍교회),90228,9,117,9,117,0,4
덕신고등학교(강화읍교회),90229,116,187,115,187,1,10
덕유마을.설악마을,55073,1558,761,1518,761,40,77
덕음,43657,29,9,29,9,0,1
덕응,43983,1,7,1,7,0,0
덕응,43986,5,19,4,19,1,0
덕정가든,43173,3,12,3,12,0,0
덕정가든,43296,26,0,26,0,0,0
덕진사거리,43870,71,5,67,5,4,2
덕진사거리,90310,9,18,9,18,0,0
덕진진,43637,4,149,4,149,0,5
덕진진,43672,48,12,45,12,3,2
덕창기계,39723,251,79,250,79,1,11
덕포리,43006,447,204,439,204,8,21
덕포리,43100,200,332,188,332,12,17
덕하교앞,43449,31,22,31,22,0,1
덕하교앞,43727,3,24,3,24,0,0
덕화2리,43468,44,10,44,10,0,1
덕화2리,43730,10,29,10,29,0,1
덕화2리마을회관,43923,30,11,30,11,0,1
덕화2리마을회관,43924,8,20,8,20,0,0
덕화3리마을회관,43609,152,87,143,87,9,7
덕화3리입구,43469,6,0,6,0,0,0
덕화3리입구,43729,16,37,16,37,0,1
덕화교회앞,90398,0,15,0,15,0,0
덕화교회앞,90399,0,2,0,2,0,0
도간마을,43612,26,0,26,0,0,0
도간마을,43664,0,34,0,34,0,1
도감말,43733,17,23,17,23,0,1
도감말,43754,18,18,16,18,2,1
도곡한신아파트,23504,54,62,54,62,0,3
도담공원.푸르지오더베뉴,89397,1660,393,1659,393,1,68
도담공원.푸르지오더베뉴,89398,2647,1838,2584,1838,63,149
도두리마을,41565,11552,1491,11505,1491,47,434
도두리마을,41566,2061,11076,2052,11076,9,437
도림동고개,39160,1525,698,1501,698,24,74
도림동고개,39161,711,1643,693,1643,18,78
도림동입구,39140,7896,1354,7876,1354,20,308
도림동입구,39141,19,2608,9,2608,10,87
도림아이파크아파트,39155,7301,3783,7188,3783,113,369
도림육교,39154,3056,6114,3009,6114,47,305
도림주공1단지,39152,16231,12260,15903,12260,328,949
도림주공1단지,39153,14888,10835,14635,10835,253,857
도림주공208동,39142,7184,3289,7016,3289,168,349
도림주공208동,39143,4989,7852,4919,7852,70,428
도림주공2단지,39146,5062,4366,4992,4366,70,314
도림주공2단지,39149,3540,2597,3418,2597,122,204
도림주철관1공장,89307,277,547,276,547,1,27
도림주철관공업(주),42293,3496,1031,3408,1031,88,150
도림포도원,39150,337,3458,331,3458,6,126
도림포도원,39151,515,365,503,365,12,29
도원고개(도원역),36001,4338,3393,4211,3393,127,257
도원고개(동구청방향),36170,16,29,16,29,0,1
도원동행정복지센터,35180,3487,2825,3329,2825,158,210
도원동행정복지센터,36128,33,245,31,245,2,9
도원동행정복지센터(앞),35788,176,125,169,125,7,10
도원동행정복지센터(앞),35798,176,51,171,51,5,7
도원역(인천축구전용경기장),35176,9943,4717,9511,4717,432,488
도원역(인천축구전용경기장),37549,1253,4357,1228,4357,25,187
도장골삼거리,44122,3,7,2,7,1,0
도장재마을,43167,23,1,22,1,1,0
도장재마을,43225,4,16,4,16,0,0
도화1동행정복지센터,37340,12731,11764,12341,11764,390,816
도화IC,37356,26173,20961,25806,20961,367,1571
도화e편한세상604동,37578,996,25,989,25,7,34
도화e편한세상아파트,37612,244,1509,244,1509,0,58
도화e편한세상아파트,37613,4519,1528,4494,1528,25,201
도화e편한세상아파트5단지,37624,3608,1145,3553,1145,55,158
도화e편한세상아파트6단지,37626,2299,3497,2262,3497,37,193
도화동신협(구박문여고),36003,10580,4488,10420,4488,160,502
도화동신협(구박문여고),37499,4903,6880,4811,6880,92,392
도화사거리.도화역,37390,950,842,932,842,18,59
도화사거리.도화역,37392,373,1141,371,1141,2,50
도화서희스타힐스,37625,978,2588,970,2588,8,118
도화역,37629,5734,6145,5704,6145,30,395
도화초등학교.수봉도서관,37366,7906,6888,7704,6888,202,493
도화초등학교.수봉도서관,37367,12824,13250,12509,13250,315,869
독골사거리,42175,3233,1398,3147,1398,86,154
독배로317번길(삼거리),37634,7457,233,7384,233,73,256
독장골,43351,2,31,2,31,0,1
독장골,43846,9,1,8,1,1,0
독정역(서구동구예비군훈련장),42377,3277,3310,3194,3310,83,219
독정역(서구동구예비군훈련장),42378,6445,4037,6333,4037,112,349
독정이고개,37234,30043,20339,29398,20339,645,1679
독정이고개,37238,19972,25827,19582,25827,390,1526
돈대마을,43925,18,5,18,5,0,0
돈대마을,43926,6,19,6,19,0,0
돈대모루,43422,6,12,6,12,0,0
돈대모루,43447,11,16,10,16,1,0
돌고래펜션,44127,0,1,0,1,0,0
돌머루(대산종점),43707,113,54,104,54,9,5
돌산밑,35320,157,30,152,30,5,6
돌산밑,35396,92,214,89,214,3,10
돌성,43364,54,184,54,184,0,7
돌성,43587,224,20,213,20,11,8
돌팍재삼거리,35273,506,715,485,715,21,40
돌팍재삼거리,35277,821,491,802,491,19,43
돌팍재한뿌리,35304,241,199,229,199,12,14
돌팍재한뿌리,35315,117,306,117,306,0,14
동강리,35245,74,54,70,54,4,4
동강리,35246,65,49,59,49,6,3
동강리,35317,42,50,40,50,2,3
동강리,35393,106,29,104,29,2,4
동검도삼거리,43223,0,48,0,48,0,1
동검도삼거리,43642,72,0,72,0,0,2
동검리마을회관입구,90069,0,10,0,10,0,0
동검리마을회관입구,90070,19,0,19,0,0,0
동검리입구,43856,4,21,4,21,0,0
동검리입구,43877,31,0,29,0,2,1
동검리종점,43889,105,58,100,58,5,5
동검상회,43226,5,0,5,0,0,0
동검상회,43519,0,5,0,5,0,0
동광리어,41083,1276,426,1242,426,34,56
동광리어,41084,774,2466,766,2466,8,108
동광제일교회,40411,541,469,528,469,13,33
동교동삼거리,22012,7404,57,7385,57,19,248
동교동삼거리,23033,66,5464,66,5464,0,184
동구노인인력개발센터,36178,1,8,1,8,0,0
동구선거관리위원회,36110,4151,10655,4049,10655,102,493
동구청,36011,533,513,526,513,7,34
동구청,36166,13,18,13,18,0,1
동구청소년수련관.달동네박물관,36026,18669,15959,18069,15959,600,1154
동구환경,36181,0,2,0,2,0,0
동국제강,36068,2157,3442,2088,3442,69,186
동국제강,36074,286,134,280,134,6,14
동국제강후문,36069,199,677,199,677,0,29
동국제강후문,36070,939,155,936,155,3,36
동남스포피아,38226,10921,7441,10681,7441,240,612
동남스포피아,38227,10989,9709,10543,9709,446,689
동남아파트,38267,1102,5242,1057,5242,45,211
동남아파트,38268,2286,770,2195,770,91,101
동남아파트,70039,464,786,459,786,5,41
동남아파트(무지개아파트),38337,1402,4406,858,4406,544,193
동녘개,90147,0,22,0,22,0,0
동녘개,90148,42,12,42,12,0,1
동녘마을입구,39660,50,868,50,868,0,30
동들머리,43705,15,7,14,7,1,0
동들머리,43885,18,59,18,59,0,2
동막교회,43499,1,46,1,46,0,1
동막교회,43514,69,4,59,4,10,2
동막역(1번출구),38039,36015,49563,35805,49563,210,2852
동막역(3번출구),38433,49085,26934,48696,26934,389,2533
동막역(4번출구),38338,9359,1153,9346,1153,13,350
동막초등학교,38054,945,4760,929,4760,16,190
동막해변,43408,114,207,111,207,3,10
동막해변,43511,312,138,294,138,18,15
동문아파트,42436,12929,15139,12754,15139,175,935
동방중학교,92038,450,455,426,455,24,30
동방초등학교,92037,15,170,14,170,1,6
동보2차아파트,41053,67,745,66,745,1,27
동보2차아파트,41059,1120,136,1093,136,27,41
동보노빌리티,35488,3551,2799,3445,2799,106,211
동보노빌리티,35489,2185,3466,2130,3466,55,188
동보아파트,39125,3490,5273,3432,5273,58,292
동보아파트,39126,5114,1756,5086,1756,28,229
동보아파트,41056,4085,527,3973,527,112,153
동보아파트,41063,761,3561,722,3561,39,144
동보아파트,41136,321,1240,314,1240,7,52
동보아파트,41143,14155,15863,13941,15863,214,1000
동보아파트,70040,415,669,404,669,11,36
동보아파트후문,41129,1501,209,1469,209,32,57
동부아파트,36052,1280,2268,1219,2268,61,118
동부아파트,37192,367,426,363,426,4,26
동산고,36018,11976,4094,11692,4094,284,535
동산고등학교,36021,5941,11547,5701,11547,240,582
동산교회,36010,2319,3078,2222,3078,97,179
동산교회,36012,3360,4799,3262,4799,98,271
동산교회,90303,3,1,3,1,0,0
동산리마을회관,90302,19,4,19,4,0,0
동산리입구,90291,9,8,9,8,0,0
동산중고등학교(재능대정문),36029,7099,1099,7049,1099,50,273
동산휴먼시아2단지,36022,2917,470,2860,470,57,112
동산휴먼시아2단지,36023,921,3863,903,3863,18,159
동산휴먼시아2단지정문,36177,7,1,7,1,0,0
동서식품,40623,2375,2688,2348,2688,27,168
동서식품,40624,2179,3560,2164,3560,15,191
동성.길훈아파트,42495,3090,4947,3044,4947,46,267
동성아파트,42496,4593,2181,4560,2181,33,225
동수교회,40184,137,1272,117,1272,20,46
동수역,40108,3037,6194,3012,6194,25,307
동수역,40110,8097,5800,7973,5800,124,463
동수역,40124,2071,12732,2001,12732,70,493
동수치안센터,40188,9424,8940,9252,8940,172,612
동수치안센터,40189,11634,12783,11342,12783,292,813
동아.팬더아파트,39233,7169,9654,7076,9654,93,560
동아.팬더아파트,39236,10070,6208,9966,6208,104,542
동아2단지정문,40324,1290,451,1257,451,33,58
동아금호아파트,38344,5477,11992,5364,11992,113,582
동아금호아파트,38347,7485,2595,7396,2595,89,336
동아아파트,37248,899,1247,887,1247,12,71
동아아파트,41070,2618,818,2553,818,65,114
동아아파트,41072,844,2606,802,2606,42,115
동아아파트,41403,1007,4164,980,4164,27,172
동아아파트,42404,3730,4268,3638,4268,92,266
동아아파트,42406,6454,3577,6272,3577,182,334
동아아파트후문,40257,2035,2246,1992,2246,43,142
동아아파트후문,40258,2308,1597,2291,1597,17,130
동아전기,42647,2,176,2,176,0,5
동아전기,42725,6,319,6,319,0,10
동아정밀,42037,1444,2689,1428,2689,16,137
동아풍림아파트,37037,15646,17908,15080,17908,566,1118
동암국민주택,40014,3506,718,3449,718,57,140
동암국민주택,40015,755,1925,729,1925,26,89
동암남부역,40034,40638,25878,40102,25878,536,2217
동암남부역,40797,134021,117372,132857,117372,1164,8379
동암남부역,40861,1097,8405,1092,8405,5,316
동암남부역,40862,18065,14013,17870,14013,195,1069
동암마트,40039,139,1929,138,1929,1,68
동암북부역,40013,33271,14909,32842,14909,429,1606
동암북부역,40035,10327,29910,10188,29910,139,1341
동암북부역광장,40800,61121,48401,60531,48401,590,3650
동암사거리,40001,13290,15348,13175,15348,115,954
동암사거리,40003,3693,5451,3653,5451,40,304
동양도서관,41522,7640,4038,7535,4038,105,389
동양도서관(휴먼빌아파트),41523,4168,5728,4119,5728,49,329
동양엔파트4단지,42820,2062,4811,1953,4811,109,229
동양엔파트4단지,42837,4360,1852,4285,1852,75,207
동양엔파트5단지,42986,2525,2956,2420,2956,105,182
동양자이입구,41554,3147,3937,3116,3937,31,236
동양자이입구,41555,3641,3065,3591,3065,50,223
동양장사거리,37301,6996,5629,6876,5629,120,420
동양주공1.2단지,41372,12214,2978,11987,2978,227,506
동양주공1.2단지,41373,2933,8250,2857,8250,76,372
동양지구1단지정문,41521,378,1488,366,1488,12,62
동양지구입구,41445,4888,501,4774,501,114,179
동양지구입구,41446,1053,6663,1048,6663,5,257
동양하이테크,42966,11,236,11,236,0,8
동원아파트,25166,220,298,219,298,1,17
동원아파트,25167,290,96,286,96,4,12
동원아파트,37376,4925,2429,4796,2429,129,245
동원아파트,37379,2134,3365,2044,3365,90,183
동인천,35188,31919,35939,31512,35939,407,2261
동인천(우리은행앞),35517,911,599,883,599,28,50
동인천동행정복지센터,35795,29,391,29,391,0,14
동인천동행정복지센터,35805,44,143,41,143,3,6
동인천역,35185,102622,51835,100893,51835,1729,5148
동인천역,35187,5757,9765,5589,9765,168,517
동인천역,35191,75994,89052,74668,89052,1326,5501
동인천역,35192,11130,22874,10676,22874,454,1133
동인천역북광장,36136,26783,16996,26404,16996,379,1459
동인천역북광장,36137,28612,15817,28094,15817,518,1480
동인천중학교,39229,1557,880,1532,880,25,81
동인천중학교,39230,1853,1302,1777,1302,76,105
동일방직,36031,3985,3570,3879,3570,106,251
동일방직,36032,3951,2701,3894,2701,57,221
동일아파트,35177,397,1287,352,1287,45,56
동주농장,43349,1,14,1,14,0,0
동주농장,43401,19,1,15,1,4,0
동촌,43407,96,1,91,1,5,3
동촌,43793,5,80,4,80,1,2
동춘2동행정복지센터,38045,1113,5935,1037,5935,76,234
동춘2동행정복지센터,38046,6016,655,5787,655,229,222
동춘동종점,38037,283,902,211,902,72,39
동춘동차고지,38569,480,283,363,283,117,25
동춘롤러경기장,38704,313,467,278,467,35,26
동춘마을아파트,38082,6778,4927,6665,4927,113,390
동춘마을아파트,38087,3104,6528,2979,6528,125,321
동춘역,38346,29776,19695,29535,19695,241,1649
동춘역(이마트),38060,13053,738,12997,738,56,459
동춘역(이마트.스퀘어원),38070,28088,36980,27909,36980,179,2168
돼지슈퍼.간동입구,80019,108,787,108,787,0,29
두두미마을,43289,8,0,8,0,0,0
두두미마을,43869,1,6,1,6,0,0
두밀경노당,89328,2,100,2,100,0,3
두밀경노당,89331,88,1,87,1,1,2
두산아파트,40564,2221,4108,2060,4108,161,210
두산위브아파트,37043,14695,8247,14436,8247,259,764
두산위브아파트,40630,10214,490,10074,490,140,356
두산위브아파트,40648,404,1141,399,1141,5,51
두운1리마을회관앞,90047,10,35,10,35,0,1
두운1리마을회관앞,90048,16,4,16,4,0,0
두운리,43034,8,41,8,41,0,1
두운리,43540,86,206,86,206,0,9
둑실경로당,41498,20,41,19,41,1,2
둑실경로당,41514,47,0,47,0,0,1
둑실동(아라마루전망대),41494,4,70,4,70,0,2
둑실동(아라마루전망대),41512,170,3,170,3,0,5
둑실동회차지,41500,57,53,57,53,0,3
둥개마을오거리,35861,24,0,24,0,0,0
둥개마을오거리,35862,2,2,2,2,0,0
둥깨마을입구(세븐일레븐),35721,15,82,15,82,0,3
둥깨마을입구(세븐일레븐),35722,43,9,41,9,2,1
둥깨마을입구(용성철강),35723,0,14,0,14,0,0
둥깨마을입구(용성철강),35724,68,2,68,2,0,2
뒤골입구,35668,33,1,33,1,0,1
뒤골입구,35669,15,23,13,23,2,1
뒷골 입구,90377,10,59,10,59,0,2
뒷골 입구,90380,62,0,61,0,1,2
뒷방죽들,39959,667,34,652,34,15,23
뒷방죽들,39960,6985,7761,6919,7761,66,491
드라이빙센터,35589,38,948,37,948,1,32
드림로갈산교,41342,68,80,66,80,2,4
드림로갈산교,41343,67,557,66,557,1,20
드림파크야생화단지,89363,895,36,736,36,159,31
드림파크야생화단지,89364,166,877,3,877,163,34
드림파크어울림,89201,31,369,27,369,4,13
드림파크어울림,89202,0,15,0,15,0,0
드무리해변,44011,32,559,32,559,0,19
드무리해변,44012,574,31,561,31,13,20
디에스솔텍,39035,3078,2171,3026,2171,52,174
디에스솔텍,39038,2451,2267,2439,2267,12,157
디에트로더힐,89455,208,109,204,109,4,10
디에트르더힐(고산터널),89396,205,505,197,505,8,23
뗏마루어린이공원·신화아파트,39405,4580,6928,4452,6928,128,383
라이크홈기숙사앞,39993,1818,867,1814,867,4,89
라이크홈기숙사앞,39994,1971,1471,1971,1471,0,114
라이크홈기숙사앞,39995,1277,93,1251,93,26,45
라이크홈기숙사앞,39996,93,869,77,869,16,32
라이프쇼핑앞,35070,6348,4318,6103,4318,245,355
라이프아파트,35060,187,5211,148,5211,39,179
라이프아파트,35062,12566,111,12283,111,283,422
래미안아파트파이낸셜뉴스,31072,8995,8304,8975,8304,20,576
래미안아파트파이낸셜뉴스,32002,3780,1490,3779,1490,1,175
랜드마크시티센트럴더샵,38636,52,2299,52,2299,0,78
랜드마크시티센트럴더샵(106동),38665,830,6730,806,6730,24,252
랜드마크시티센트럴더샵(106동),38666,6506,531,6342,531,164,234
랜드마크시티센트럴더샵(203동),38645,7516,469,7405,469,111,266
랜드마크시티센트럴더샵(203동),38650,558,6465,541,6465,17,234
럭키아파트,23488,267,144,267,144,0,13
럭키아파트,38115,4066,133,3959,133,107,139
럭키아파트,38132,1433,8860,1405,8860,28,343
레이크파크,42840,1486,4732,1411,4732,75,207
레전드호텔,35639,1794,1698,1775,1698,19,116
레전드호텔,35640,1240,1607,1216,1607,24,94
레지던스라이크홈,92012,336,4184,336,4184,0,150
로봇랜드입구,89022,4263,96,4169,96,94,145
로봇랜드입구,89023,24,1938,17,1938,7,65
로봇타워,89301,5,203,3,203,2,6
로봇타워,89302,511,30,367,30,144,18
로얄금속,40599,5821,3553,5736,3553,85,312
로얄아파트,37247,32091,14338,31614,14338,477,1547
로얄아파트,37424,669,297,661,297,8,32
로얄타운,42047,1679,2404,1637,2404,42,136
로얄호텔,43542,9,18,9,18,0,0
로얄호텔,43878,44,24,44,24,0,2
롯데마트,35108,2919,4668,2827,4668,92,252
롯데마트,41390,921,53,909,53,12,32
롯데마트,41391,56,2156,45,2156,11,73
롯데마트,42829,15823,8533,15749,8533,74,811
롯데마트,42838,8512,17184,8379,17184,133,856
롯데마트계양점(고용복지센터),41227,27101,17672,26637,17672,464,1492
롯데마트계양점(고용복지센터),41424,10160,18896,10060,18896,100,968
롯데마트송도점,38523,2376,700,2335,700,41,102
롯데몰.김포공항,25174,296,1366,296,1366,0,55
롯데백화점(인천터미널),37513,181989,163176,179507,163176,2482,11505
롯데백화점(인천터미널),39588,171275,123157,168504,123157,2771,9814
롯데슈퍼,38072,7965,2864,7846,2864,119,360
롯데슈퍼,38074,2400,7473,2323,7473,77,329
롯데슈퍼,42206,2747,4552,2661,4552,86,243
롯데슈퍼,42207,7099,2402,6961,2402,138,316
롯데아파트,38110,6582,8992,6435,8992,147,519
롯데우람아파트,42152,4628,6502,4568,6502,60,371
롯데우람아파트,42603,3229,5094,3181,5094,48,277
롯데월드타워,37327,3194,5448,3064,5448,130,288
롯데캐슬,39795,348,223,335,223,13,19
롯데캐슬,39796,2131,866,2070,866,61,99
롯데캐슬,39797,376,75,350,75,26,15
롯데캐슬,39798,72,245,70,245,2,10
롯데캐슬,42835,7413,4753,7345,4753,68,405
롯데캐슬,42884,4916,9903,4594,9903,322,493
롯데캐슬,42999,914,3341,868,3341,46,141
롯데캐슬.모래내시장,39309,56309,21624,55474,21624,835,2597
롯데캐슬·모래내시장·구월시장,39310,30194,52036,29835,52036,359,2741
롯데캐슬캠퍼스타운,39977,10,671,6,671,4,22
롯데캐슬캠퍼스타운,39978,1766,2358,1720,2358,46,137
롯데캐슬후문,39285,4270,4097,4206,4097,64,278
루에블리아파트,89283,820,4145,792,4145,28,165
루에블리아파트,89284,6183,6841,6054,6841,129,434
루원더퍼스트아파트,89107,3362,5429,3250,5429,112,293
루원더퍼스트아파트,89108,7729,2064,7686,2064,43,326
루원더퍼스트아파트105동앞,89378,95,1289,87,1289,8,46
루원숲속마을,89383,141,433,141,433,0,19
루원숲속마을,89384,347,104,344,104,3,15
루원시티2차리더스뷰아파트,89072,3792,4726,3764,4726,28,283
루원시티사거리,89076,389,606,366,606,23,33
루원시티프라디움,89150,15441,3377,15341,3377,100,627
루원시티프라디움105동,89308,6166,11052,6012,11052,154,573
루원시티프라디움105동,89309,3113,5468,3032,5468,81,286
루원이편한세상하늘채(107동),42225,8857,16636,8667,16636,190,849
루원이편한세상하늘채(112동),42721,4874,1952,4773,1952,101,227
루원이편한세상하늘채(125동),42216,6193,2894,6063,2894,130,302
루원제일풍경채정문앞,89040,3212,9752,3147,9752,65,432
루원지웰시티푸르지오,42228,4973,6519,4782,6519,191,383
루원호반베르디움,89149,4983,12487,4756,12487,227,582
루원호반베르디움104동,89368,564,1015,558,1015,6,52
리안월드입구,90177,57,34,57,34,0,3
리안월드입구,90178,57,17,57,17,0,2
린나이코리아,40011,22,310,2,310,20,11
린나이코리아,40012,420,1,420,1,0,14
린스트라우스,42881,7736,2629,7535,2629,201,345
린스트라우스정문,42795,6352,3745,6285,3745,67,336
린스트리우스,42831,2464,2593,2460,2593,4,168
마그네,43028,157,207,139,207,18,12
마그네다리,43158,282,136,275,136,7,13
마그네다리,43900,14,12,12,12,2,0
마그네사거리,43029,316,327,290,327,26,21
마그네사거리,43030,480,286,460,286,20,25
마니산상회,43417,142,23,129,23,13,5
마니산상회,43443,46,116,43,116,3,5
마니산입구,43102,205,673,200,673,5,29
마니산입구,43103,758,224,755,224,3,32
마당개,35681,66,63,62,63,4,4
마당개,35697,40,10,40,10,0,1
마린월드,70004,1120,122,1099,122,21,41
마린월드,70029,7,176,0,176,7,6
마미,43747,43,17,43,17,0,2
마미,43765,7,13,7,13,0,0
마송,80131,539,4635,537,4635,2,172
마송,80132,3173,758,3120,758,53,131
마시란,35424,92,473,90,473,2,18
마시란,35425,385,87,383,87,2,15
마시란해변(슈퍼앞),35262,2,9,2,9,0,0
마시란해변(슈퍼앞),35263,10,0,10,0,0,0
마시란해변(전주집),35260,0,2,0,2,0,0
마시란해변(전주집),35261,28,0,28,0,0,0
마시란해변승마장,35212,10,2,10,2,0,0
마시란해변승마장,35213,1,1,1,1,0,0
마을금고,40528,1844,5446,1779,5446,65,243
마을회관,43314,38,0,38,0,0,1
마을회관,43773,0,18,0,18,0,0
마을회관입구,35024,272,1886,219,1886,53,71
마을회관입구,35402,1242,128,1217,128,25,45
마장공원,40286,7024,31,6931,31,93,235
마장포,35679,11,1,11,1,0,0
마장포,35699,93,49,81,49,12,4
마장포고개,35677,53,25,48,25,5,2
마장포고개,35701,32,14,32,14,0,1
마전고등학교,42752,106,8111,86,8111,20,273
마전고등학교,42753,6003,310,5815,310,188,210
마전역,42412,3409,8536,3317,8536,92,398
마전역,42413,19375,4845,19101,4845,274,807
마전주공아파트,42420,39,139,25,139,14,5
마전주공아파트,89322,0,3,0,3,0,0
마전지구대원아파트,42481,5138,77,4925,77,213,173
마전지구대원아파트,89446,16,3516,14,3516,2,117
마전지구버스차고지,89259,4175,143,3959,143,216,143
마전지구버스차고지,89345,219,2145,54,2145,165,78
마전초등학교,42408,5877,5835,5804,5835,73,390
막촌,43460,273,14,243,14,30,9
막촌,43776,0,121,0,121,0,4
만석동행정복지센터,36046,4285,1890,4159,1890,126,205
만석부두,36076,420,3335,394,3335,26,125
만석부두,36079,4349,1591,4294,1591,55,198
만석비치타운,36106,615,8748,581,8748,34,312
만석비치타운,36126,1667,919,1499,919,168,86
만석삼거리,36185,2603,2435,2526,2435,77,167
만석삼거리,36186,1313,2152,1278,2152,35,115
만석어린이공원,36182,24,502,3,502,21,17
만석주공,36057,14300,2511,13978,2511,322,560
만석초등학교,36056,857,213,821,213,36,35
만석초등학교,36187,0,104,0,104,0,3
만수1동행정복지센터,39294,11555,5074,11423,5074,132,554
만수2동행정복지센터·포레시안,39731,15402,9652,15232,9652,170,835
만수2동행정복지센터·포레시안,39735,9461,10891,9354,10891,107,678
만수3동주민센터,39425,19964,27144,19712,27144,252,1570
만수3동주민센터,39427,32006,13484,31785,13484,221,1516
만수3동주민센터,39544,569,156,560,156,9,24
만수3동주민센터,39545,86,1059,85,1059,1,38
만수4동주민센터,39452,6960,6772,6818,6772,142,457
만수4동주민센터,39454,6640,11982,6523,11982,117,620
만수6동주민센터입구,39277,4541,12164,4506,12164,35,556
만수7.8단지앞,39497,895,2037,881,2037,14,97
만수7.8단지앞,39635,2574,2225,2553,2225,21,159
만수북중학교,39468,1101,1857,1069,1857,32,98
만수북중학교,39469,2179,607,2109,607,70,92
만수북초등학교,39420,7206,5035,7099,5035,107,408
만수소방서,39428,9756,17236,9664,17236,92,899
만수소방서,39433,36998,13701,36625,13701,373,1689
만수신동아아파트·동인천고,39485,10914,10948,10083,10948,831,728
만수신동아아파트·동인천고,39578,393,36,375,36,18,14
만수역,39385,3680,89,3673,89,7,125
만수역,39388,424,18948,388,18948,36,645
만수종합시장,39451,29653,9719,28957,9719,696,1312
만수종합시장,39592,9358,22471,9221,22471,137,1060
만수주공1단지,39401,3489,3164,3471,3164,18,221
만수주공320동앞,39431,1345,1678,1319,1678,26,100
만수주공4단지,39440,7054,5480,6990,5480,64,417
만수주공4단지,39443,10288,7898,10160,7898,128,606
만수주공정문,39408,10573,8295,10457,8295,116,628
만수주공정문,39410,3059,3116,2980,3116,79,205
만수주공후문,39429,4007,5814,3980,5814,27,327
만수주공후문,39435,1533,6713,1494,6713,39,274
만수주공후문,39438,14361,4018,14167,4018,194,612
만수중(대토단지),39400,379,1667,377,1667,2,68
만수중학교후문,39745,126,900,125,900,1,34
만수초등학교,39303,1588,5010,1545,5010,43,219
만수초등학교,39307,712,906,695,906,17,53
만수치안센터,39455,798,543,782,543,16,44
만월종합사회복지관,92065,2,1762,2,1762,0,58
만월중학교,39962,2421,347,2360,347,61,92
만월중학교,39963,87,2749,81,2749,6,94
만의골입구,39666,91,93,91,93,0,6
만의골입구,39672,35,268,34,268,1,10
만정낚시터,35682,52,29,50,29,2,2
만정낚시터,35696,24,31,24,31,0,1
만정낚시터입구,35683,27,26,27,26,0,1
만정낚시터입구,35695,20,28,20,28,0,1
망양돈대,90224,5,23,5,23,0,0
망양돈대,90225,9,5,9,5,0,0
망월3리,43332,228,131,211,131,17,11
망월3리,43580,1,25,0,25,1,0
망월입구,43117,20,2,19,2,1,0
망월입구,43576,53,41,50,41,3,3
망월입구,43790,10,40,10,40,0,1
망월종점,43788,1,9,1,9,0,0
매음1리마을회관,90173,21,21,21,21,0,1
매음1리마을회관,90174,22,9,22,9,0,1
매음3리마을회관(민머루),90321,12,16,12,16,0,0
매음3리마을회관(민머루),90322,21,2,17,2,4,0
매제미고개,43837,2,0,2,0,0,0
매제미고개,43988,14,29,11,29,3,1
먼우금사거리,38114,6711,4051,6671,4051,40,358
먼우금초등학교,38021,2866,10963,2798,10963,68,460
메이루즈커낼파크뷰,42747,3868,9754,3613,9754,255,454
메이루즈커낼파크뷰,42762,11007,3529,10712,3529,295,484
메이루즈커낼파크뷰정문,42794,3886,3892,3789,3892,97,259
메제미,43302,161,19,153,19,8,6
메제미,43598,1,206,1,206,0,6
면사무소입구,90018,15,229,13,229,2,8
면사무소입구,90019,122,19,116,19,6,4
면허시험장,39006,1811,1648,1804,1648,7,115
명가빌라(회차),37553,2258,2181,2084,2181,174,147
명보주택앞,43979,10,20,10,20,0,1
명보주택앞,43984,24,12,24,12,0,1
명신여자고등학교,40289,19220,5185,18786,5185,434,813
명신여자고등학교,40291,5795,11891,5704,11891,91,589
명신초등학교,43394,54,3,46,3,8,1
명신초등학교,43803,3,83,2,83,1,2
명진부페,43632,14,4,14,4,0,0
명현중학교,41405,2572,7579,2534,7579,38,338
명현초등학교,41559,5268,1400,5241,1400,27,222
명현초등학교,41560,1161,3710,1142,3710,19,162
명현초등학교(효성지구대),41069,823,2997,786,2997,37,127
모다아울렛,89190,2664,2815,2639,2815,25,182
모래내시장,39295,14808,13442,14491,13442,317,941
모래내시장,39298,12679,10696,12383,10696,296,779
모래내시장,39344,6045,5965,6045,5965,0,400
모래내시장,39350,10662,12052,10443,12052,219,757
모래내시장역(1번출구),39338,11704,8930,11458,8930,246,687
모래내시장역(2번출구),39909,8486,11923,8305,11923,181,680
모래내시장역(3번출구),39339,32521,30540,32230,30540,291,2102
모래내시장역(4번출구),39335,1814,5902,1780,5902,34,257
모래방죽사거리,89228,1413,905,1344,905,69,77
모래방죽사거리,89229,1420,3107,1406,3107,14,150
모름말,90255,21,2,16,2,5,0
모름말,90311,0,2,0,2,0,0
모리부락입구,90304,13,0,13,0,0,0
모아아파트,70033,268,644,265,644,3,30
모아아파트.세종프라자,70034,592,179,573,179,19,25
모현,43659,2,279,2,279,0,9
모현,43689,257,10,255,10,2,8
목감IC진입(미정차),70226,6,0,6,0,0,0
목개마을,90153,13,5,13,5,0,0
목개마을,90154,13,10,12,10,1,0
목너머,35863,48,23,48,23,0,2
목너머,35864,5,31,5,31,0,1
목련어린이집,40824,8502,3567,8402,3567,100,402
목비고개,43032,71,131,53,131,18,6
목비고개,43272,193,58,175,58,18,8
목상교입구,41493,19,10,19,10,0,0
목상교입구,41519,9,9,9,9,0,0
목상교차로,41636,3,256,3,256,0,8
목상교차로,41637,185,9,179,9,6,6
목상동(새봄농원입구),41323,0,93,0,93,0,3
목상동(새봄농원입구),41324,46,4,46,4,0,1
목상동마을입구,41318,2,236,2,236,0,7
목상동마을입구,41517,189,38,185,38,4,7
목상동솔밭.이주단지입구,41316,1600,37,1583,37,17,54
목상동솔밭.이주단지입구,41317,17,1015,9,1015,8,34
목장앞,43503,0,5,0,5,0,0
목장앞,43688,4,3,4,3,0,0
목재단지,42036,412,599,406,599,6,33
목재부두사거리,42949,3,361,3,361,0,12
목재부두사거리,42960,66,50,66,50,0,3
목화빌라,37545,7,320,3,320,4,10
목화예식장,39446,15365,12489,15126,12489,239,928
목화예식장,39448,14574,21654,14441,21654,133,1207
무내미마을,39496,506,966,493,966,13,49
무내미마을,40106,127,3325,116,3325,11,115
무의공영주차장,35871,11,18,11,18,0,0
무의도입구,35001,5975,402,5894,402,81,212
무의도입구,35002,607,6164,597,6164,10,225
무의도주민자치센터,35738,426,42,420,42,6,15
무의도주민자치센터,35739,91,313,91,313,0,13
무지개.한양8차아파트,40271,6709,3703,6611,3703,98,347
무지개.한양8차아파트,40276,5679,8919,5556,8919,123,486
무지개아파트,38366,3628,2442,3507,2442,121,202
무지개아파트(동남아파트),38042,7251,1212,6806,1212,445,282
무학리입구,90276,44,38,44,38,0,2
묵골,43498,24,10,17,10,7,1
묵골,43684,9,13,4,13,5,0
문남마을,38250,9518,5323,9394,5323,124,494
문남초등학교,38214,2338,2405,2294,2405,44,158
문남초등학교,38216,3100,3705,3006,3705,94,226
문말3거리,44084,3,1,3,1,0,0
문말3거리,44169,1,0,0,0,1,0
문말삼거리,44001,318,41,312,41,6,11
문말삼거리,44002,24,391,23,391,1,13
문산교회앞,43340,20,30,15,30,5,1
문산교회앞,43589,35,15,28,15,7,1
문산리마을회관,43101,89,350,77,350,12,14
문일여고·하우스토리만수아파트,39313,1384,3945,1362,3945,22,177
문일여고·하우스토리만수아파트,39314,5732,884,5607,884,125,220
문일여자고등학교후문,39685,2159,3993,2099,3993,60,205
문학경기장(X게임장),37643,108,155,79,155,29,8
문학경기장(박태환수영장),38310,3453,2271,3421,2271,32,190
문학경기장(박태환수영장),38311,1209,3649,1186,3649,23,161
문학경기장(박태환수영장),38329,1313,1153,1268,1153,45,82
문학경기장(박태환수영장),38423,865,2076,848,2076,17,98
문학경기장(야구장),37144,4845,10229,4588,10229,257,502
문학경기장(월드컵경기장),37157,4407,9088,4204,9088,203,449
문학경로당,37087,4989,3257,4905,3257,84,274
문학경로당,37088,4304,3801,4109,3801,195,270
문학고개,37056,3127,2499,3043,2499,84,187
문학고개,37057,2761,3563,2665,3563,96,210
문학고개,37101,2968,4127,2895,4127,73,236
문학우체국,37520,4125,4739,3960,4739,165,295
문학우체국,37521,5812,3304,5713,3304,99,303
문학정보고입구,37107,4090,5657,3987,5657,103,324
문학정보고입구,37108,6093,2248,5927,2248,166,278
문학초등학교,37105,21452,8211,20979,8211,473,988
문학초등학교,37110,8541,15815,8283,15815,258,811
문현,43005,58,78,53,78,5,4
문현,43164,35,30,35,30,0,2
문현,43195,152,15,139,15,13,5
문현,43321,13,138,13,138,0,5
문화교회,40173,399,253,385,253,14,21
문화교회,40174,9485,10327,9299,10327,186,660
문화예술회관,39197,3728,6563,3693,6563,35,343
문화예술회관,39199,931,738,914,738,17,55
물류단지D블럭앞,35604,374,7,374,7,0,12
물류단지F블럭앞,35603,3,452,3,452,0,15
물왕TG(미정차),70223,1,0,1,0,0,0
미관광장,38508,2,80,2,80,0,2
미관광장,38512,23,15,23,15,0,1
미단교회사거리,35664,65,44,63,44,2,3
미단교회사거리,35665,11,24,11,24,0,1
미도아파트,37446,1086,1279,1080,1279,6,78
미도아파트,41027,10724,3347,10605,3347,119,469
미도아파트,41028,3885,10330,3797,10330,88,473
미래빌라,36088,6053,849,5899,849,154,230
미래빌라,36089,1416,4317,1389,4317,27,191
미래타운1.2단지,40683,4763,18482,4616,18482,147,774
미래타운1.2단지,40684,13483,2922,13319,2922,164,546
미래타운5단지,40672,1011,3990,996,3990,15,166
미래타운5단지501동,40662,5782,345,5726,345,56,204
미래타운5단지505동,40669,6679,3112,6509,3112,170,326
미래테크원,92015,2242,760,2227,760,15,100
미루지,43420,24,27,21,27,3,1
미루지,43522,58,20,56,20,2,2
미륭아파트,36138,3733,506,3658,506,75,141
미륭아파트,36139,550,3198,534,3198,16,124
미림극장,36008,1517,6587,1413,6587,104,270
미림극장,36009,8138,1992,7926,1992,212,337
미림극장입구,36141,134,281,126,281,8,13
미산초등학교,40378,7063,9650,6899,9650,164,557
미송초등학교,38654,15802,956,15441,956,361,558
미송초등학교(하행),38653,2027,8887,1905,8887,122,363
미주탕,42123,3260,10737,3186,10737,74,466
미주탕,42124,11271,5367,10968,5367,303,554
미추홀경찰서(장미아파트),37524,850,3722,809,3722,41,152
미추홀공원,38368,7798,2745,7604,2745,194,351
미추홀구청,37304,4593,3780,4428,3780,165,279
미추홀구청,37307,754,2343,746,2343,8,103
미추홀구청입구,37306,9011,17205,8870,17205,141,873
미추홀구청입구,37312,10321,11537,10075,11537,246,728
미추홀구평생학습관,37073,6284,5832,6165,5832,119,403
미추홀도서관·인천신월초등학교,39270,3957,8417,3856,8417,101,412
미추홀아파트,40250,117,462,114,462,3,19
미추홀아파트,40254,248,244,246,244,2,16
미추홀외고,39689,460,884,439,884,21,44
미추홀외고,39690,820,363,785,363,35,39
미추홀퍼스트(2단지),37220,8550,3300,8344,3300,206,395
미추홀퍼스트(2단지),37642,3430,8730,3291,8730,139,405
미추홀퍼스트2단지,37646,2594,392,2549,392,45,99
미추홀퍼스트3단지,37647,659,3089,637,3089,22,124
민머루해수욕장,90336,11,8,11,8,0,0
민방위교육장,38610,77,468,77,468,0,18
민방위교육장,38611,502,221,502,221,0,24
민방위교육장,39733,7901,2479,7810,2479,91,346
민방위교육장,39734,58,2395,48,2395,10,81
민방위교육장입구,41043,1982,5734,1922,5734,60,257
바로크아파트,42530,860,506,836,506,24,45
박공현,43228,36,3,33,3,3,1
박공현,43294,5,26,5,26,0,1
박문여자고등학교,39799,975,229,914,229,61,40
박문여자고등학교,39800,403,503,390,503,13,30
박문중학교,39844,454,157,433,157,21,20
박문중학교,39847,378,2890,368,2890,10,108
박문중학교정문,39860,3457,257,3351,257,106,123
박문중학교후문,39859,218,76,207,76,11,9
박물관앞,43668,18,135,18,135,0,5
박물관앞,43698,189,39,176,39,13,7
박촌마을입구,35670,154,13,144,13,10,5
박촌마을입구,35671,14,234,10,234,4,8
박촌역,41309,18072,23165,17758,23165,314,1374
박촌역,41310,17403,11951,17244,11951,159,978
반달마을.법원.검찰청,55014,1572,4108,1558,4108,14,189
반도유보라,42904,572,2271,548,2271,24,94
반도유보라,42905,2940,458,2831,458,109,113
반도유보라,42963,2077,790,1983,790,94,95
반도유보라,42985,3121,1507,3071,1507,50,154
반디모텔,44126,6,0,6,0,0,0
반디모텔,44170,0,1,0,1,0,0
반찬단지,89426,602,263,589,263,13,28
반찬단지,89427,726,207,716,207,10,31
반포역,31034,121,3477,121,3477,0,119
반포역,31035,5506,89,5504,89,2,186
발산초등학교(풍림아이원),42433,228,135,221,135,7,12
발전소삼거리,44115,85,140,80,140,5,7
발전소삼거리,44171,2,0,2,0,0,0
밝게,43990,15,1,15,1,0,0
밝게,43991,0,13,0,13,0,0
밤나무골,43022,62,124,57,124,5,6
밤나무골,43023,132,98,132,98,0,7
방개마을,90141,39,11,38,11,1,1
방개마을,90142,16,6,16,6,0,0
방아머리,62008,297,61,276,61,21,11
방아머리,62032,49,152,47,152,2,6
방아머리선착장,62007,52,417,51,417,1,15
방아머리제1주차장,62031,50,301,50,301,0,11
방아머리제1주차장,62041,466,73,452,73,14,17
방죽골,39763,2098,2850,2030,2850,68,164
방죽골,39764,980,2688,967,2688,13,122
방죽말,43027,70,89,69,89,1,5
방죽말,43214,48,122,39,122,9,5
방죽삼거리,39173,340,1071,332,1071,8,47
방죽삼거리,39174,711,476,690,476,21,39
방죽삼거리,42681,1796,591,1749,591,47,79
방죽삼거리,42683,424,1134,419,1134,5,51
방촌공원,40419,2541,2727,2515,2727,26,175
방축삼거리,36159,552,433,547,433,5,32
방파제입구,35048,8,970,3,970,5,32
방화동도시개발11단지,25026,987,54,956,54,31,34
방화중학교,25008,4520,128,4483,128,37,154
방화중학교,25009,35,1162,32,1162,3,39
배다리,35186,10542,18422,10392,18422,150,965
배다리삼거리,36006,11970,8879,11666,8879,304,694
배다리삼거리,36007,7471,8685,7236,8685,235,538
배다리성냥마을박물관,36167,11,25,11,25,0,1
배다리청과물시장,35184,4260,2810,4157,2810,103,235
배다리헌책방거리,36158,450,608,411,608,39,35
배수지입구,42774,583,10,554,10,29,19
백두아파트,42632,9021,4138,8830,4138,191,438
백련사입구,43419,22,60,22,60,0,2
백련사입구,43808,15,5,13,5,2,0
백련산입구,35773,5,2,4,2,1,0
백련산입구,35778,0,30,0,30,0,1
백마장입구,40389,10649,2713,10531,2713,118,445
백마장입구,40390,2437,9674,2396,9674,41,403
백마장입구,40399,17903,18952,17690,18952,213,1228
백마장입구,40407,8735,9025,8591,9025,144,592
백병원(송림패션몰),36151,373,58,360,58,13,14
백사장회센터,62033,15,164,14,164,1,5
백사장회센터,62039,191,31,189,31,2,7
백산아파트,38112,3386,4488,3180,4488,206,262
백산아파트,38113,3668,4152,3549,4152,119,260
백산아파트,38328,1906,1569,1836,1569,70,115
백석고가(하이마트),42381,3714,3155,3596,3155,118,228
백석고가(하이마트),42578,4086,3976,3964,3976,122,268
백석마을,35096,0,5,0,5,0,0
백석중.고등학교,42374,6700,3733,6457,3733,243,347
백석중.고등학교,42375,3919,6361,3757,6361,162,342
백석중사거리,89238,9,61,8,61,1,2
백석중사거리,89239,49,354,24,354,25,13
백승아파트,41383,124,569,91,569,33,23
백승아파트,41384,143,297,141,297,2,14
백암왕순대앞,38483,2167,1752,2118,1752,49,130
백영아파트,40058,10097,4888,9846,4888,251,499
백영아파트,41361,8011,63,7929,63,82,269
백운곡,43040,193,73,186,73,7,8
백운곡,43295,73,230,73,230,0,10
백운공원,40072,18,709,6,709,12,24
백운공원(부평아트센터),40075,663,4510,643,4510,20,172
백운공원(부평아트센터),40076,3481,1213,3382,1213,99,156
백운역,40079,14942,21414,14791,21414,151,1211
백운역,40080,25142,21483,24977,21483,165,1554
백운역,40081,58993,52161,58567,52161,426,3705
백운역,40716,12395,3036,12217,3036,178,514
백운역(파출소),40094,98,2157,96,2157,2,75
백운역(하행),40901,2479,8443,2447,8443,32,364
백운프라자,37181,4315,10098,4188,10098,127,480
백운프라자,37185,7387,4374,7213,4374,174,392
백조아파트,40386,310,764,306,764,4,35
백조아파트,40388,1378,734,1335,734,43,70
뱃말항,44172,0,5,0,5,0,0
뱅뱅사거리,31012,4,1963,4,1963,0,65
뱅뱅사거리,32001,2320,13,2320,13,0,77
버드러지,43428,18,20,18,20,0,1
버드러지,43476,102,25,96,25,6,4
번영로제1사거리,39113,269,1261,266,1261,3,51
번영로제3사거리,39036,1083,264,1068,264,15,44
번영로제3사거리,39037,222,1196,202,1196,20,47
벌말,43175,4,31,4,31,0,1
벌말,43297,59,1,57,1,2,2
벌판마을입구,35763,8,119,8,119,0,4
벌판마을입구,35764,124,60,123,60,1,6
범양상가,42118,4538,11175,4486,11175,52,523
범양상가,42122,10598,2394,10397,2394,201,433
범양아파트,42116,8865,2895,8655,2895,210,392
범양아파트(종점),42127,118,6,117,6,1,4
범허리종점,43974,59,46,53,46,6,3
법원,37130,300,1927,288,1927,12,74
법원,37131,1840,1139,1818,1139,22,99
법원.검찰청,37074,7557,5510,7448,5510,109,435
법원.검찰청.복사골문화센터.반달마을,55020,4226,2487,4143,2487,83,223
법원검찰청입구,37078,3569,4173,3486,4173,83,258
베어즈베스트골프장,89268,496,1332,489,1332,7,60
베어즈베스트골프장,89269,434,3320,430,3320,4,125
베어즈베스트청라GC,89046,71,198,69,198,2,8
베어즈베스트청라GC,89047,86,308,77,308,9,13
벧엘교회,39740,187,1449,147,1449,40,54
벽산.이삭아파트,39453,20752,26222,20601,26222,151,1565
벽산1차아파트,70023,131,1582,125,1582,6,57
벽산1차아파트,70024,2161,255,2105,255,56,80
벽산아파트,39459,2135,54,2093,54,42,72
벽산아파트,39549,19,3626,15,3626,4,121
벽산아파트(미추홀도서관),39273,13087,4129,12910,4129,177,573
벽산이삭아파트,39458,20460,12821,20239,12821,221,1109
별립산입구,43588,4,134,3,134,1,4
별립산입구,43778,97,0,77,0,20,3
병무청(학익풍림아이원),37013,48,28,43,28,5,2
병무청(학익풍림아이원),37671,20,1198,16,1198,4,40
병방사거리,41301,459,3208,437,3208,22,122
병방사거리,41303,6088,1945,5948,1945,140,267
병방초등학교,41302,663,964,651,964,12,54
병방초등학교,41304,1598,1235,1563,1235,35,94
병방초등학교(계양산전통시장),41299,17293,13808,17022,13808,271,1036
보건소,43626,1,59,1,59,0,2
보건환경연구원,35158,2330,2201,2263,2201,67,151
보람프라자앞,42442,28144,17375,27862,17375,282,1517
보릿고개,43517,26,390,22,390,4,13
보릿고개,43880,294,103,281,103,13,13
보무기,90165,22,53,20,53,2,2
보무기,90166,49,26,48,26,1,2
보문사,90206,1939,1561,1875,1561,64,116
보스턴힐,89461,2,14,2,14,0,0
보스턴힐,89462,1,14,1,14,0,0
보트비,89424,37,330,36,330,1,12
보트비,89425,159,39,157,39,2,6
보훈회관,39484,5400,8427,5307,8427,93,460
복사골문화센터.한아름마을,55026,2251,3857,2240,3857,11,203
복지회관,38079,2142,1304,2123,1304,19,114
복지회관,38080,1013,3632,962,3632,51,154
본향교회,39164,12877,2784,12596,2784,281,522
볼보트럭남인천사업소,35814,583,848,566,848,17,47
봉골,43535,16,3,15,3,1,0
봉골,43673,8,36,8,36,0,1
봉성(오상2리),43261,0,61,0,61,0,2
봉성(오상2리),43377,94,3,87,3,7,3
봉소리마을회관,43000,42,5,39,5,3,1
봉소리마을회관,90001,5,42,5,42,0,1
봉수초등학교,42980,78,459,78,459,0,17
봉수초등학교,42981,108,922,108,922,0,34
봉수파출소,42982,1036,1830,1029,1830,7,95
부개1동행정복지센터,40191,2889,6469,2843,6469,46,311
부개1동행정복지센터,40193,7745,4849,7536,4849,209,419
부개2동행정복지센터,40323,1736,513,1716,513,20,74
부개2파출소,40317,387,299,380,299,7,22
부개2파출소,40318,3437,4799,3299,4799,138,274
부개2파출소,40329,4513,1688,4404,1688,109,206
부개2파출소,40764,83,221,81,221,2,10
부개3동행정복지센터,40494,1510,302,1480,302,30,60
부개3동행정복지센터입구,40486,162,1305,157,1305,5,48
부개6단지후문.웅진플레이,55021,42,2205,33,2205,9,74
부개고입구,40345,4106,5003,3953,5003,153,303
부개고입구,40783,6270,2801,6161,2801,109,302
부개농협,40199,463,2454,433,2454,30,97
부개농협,40201,2672,946,2593,946,79,120
부개서초등학교,40243,1641,784,1628,784,13,80
부개성일아파트,40293,7563,3409,7398,3409,165,365
부개성일아파트,40301,5742,10883,5514,10883,228,554
부개여자고등학교,40421,3035,1311,3026,1311,9,144
부개여자고등학교,40422,2232,2375,2196,2375,36,153
부개여자고등학교,40423,8783,5147,8683,5147,100,464
부개여자고등학교,40428,3714,5640,3659,5640,55,311
부개역,40222,2433,9481,2335,9481,98,397
부개역,40223,7726,3895,7526,3895,200,387
부개역,40256,35777,19622,34825,19622,952,1846
부개우체국,40458,9449,6762,9331,6762,118,540
부개종합시장,40504,8796,3963,8625,3963,171,425
부개주공2단지,40772,456,714,448,714,8,39
부개주공3단지,40479,3140,1103,3100,1103,40,141
부개주공3단지정문,40460,424,759,411,759,13,39
부개주공3단지후문,40500,3828,6094,3763,6094,65,330
부개주공6단지,40442,3988,2389,3950,2389,38,212
부개주공6단지,40459,3725,3941,3707,3941,18,255
부개주공7단지,40385,7868,3542,7805,3542,63,380
부개주공7단지,40387,3500,5679,3469,5679,31,305
부광여자고등학교,40471,496,1693,485,1693,11,72
부광초등학교,40434,1316,4005,1268,4005,48,177
부광초등학교,40440,5239,1924,5105,1924,134,238
부근삼거리,43586,590,114,557,114,33,23
부근삼거리,43652,124,469,122,469,2,19
부대아래,90106,5,7,4,7,1,0
부대아래,90107,15,13,15,13,0,0
부대앞,18392,171,3,166,3,5,5
부대앞,18397,2,62,1,62,1,2
부대앞,38594,133,322,129,322,4,15
부대앞,41321,140,581,129,581,11,24
부대앞,41322,326,1034,324,1034,2,45
부대앞,41531,9,116,9,116,0,4
부대앞,41532,57,76,57,76,0,4
부대앞,42342,214,621,205,621,9,27
부대앞,42343,104,238,104,238,0,11
부대앞,43435,39,16,39,16,0,1
부대앞,43787,72,29,68,29,4,3
부동산입구,38278,2934,1417,2910,1417,24,145
부동산입구,38743,148,603,144,603,4,25
부명고.순천향대학병원,55036,1998,6072,1975,6072,23,269
부원여중·동아아파트,40202,5640,1937,5496,1937,144,252
부원여중·동아아파트,40208,1080,5108,1057,5108,23,206
부원중학교,40181,26736,16106,25956,16106,780,1428
부원중학교,40789,10757,28208,10524,28208,233,1298
부일여자중학교,40123,15748,2819,15620,2819,128,618
부천IC,57023,2738,2786,2717,2786,21,184
부천IC,57025,4062,2661,4021,2661,41,224
부천시청역1번출구,55061,2655,880,2654,880,1,117
부천시청역2번출구.현대백화점.이마트,55054,17642,7969,17476,7969,166,853
부천시청역3번출구.경기예고.현대백화점,55057,7788,10287,7768,10287,20,602
부천시청역4번출구.현대백화점.경기예고,55059,9457,7127,9388,7127,69,552
부천시청역5번출구,55060,1545,5004,1540,5004,5,218
부천실내체육관,55075,888,1680,883,1680,5,85
부천오정물류단지(중),57042,475,870,471,870,4,44
부천오정물류단지(중),57043,485,826,485,826,0,43
부천자동차검사소,57017,1032,1771,1018,1771,14,93
부천자동차검사소,57041,1455,1655,1451,1655,4,103
부천터미널소풍,55051,2163,8096,2146,8096,17,341
부천테크노파크1.2단지,57001,1623,2332,1615,2332,8,131
부천테크노파크1단지,57003,2099,2258,2086,2258,13,145
부평2동행정복지센터,40744,337,998,305,998,32,44
부평4동성당,40377,3234,2607,3142,2607,92,194
부평6동우체국,40186,1393,482,1364,482,29,62
부평6동행정복지센터,40906,5574,206,5319,206,255,192
부평LH1(2)단지,40160,6728,7661,6591,7661,137,479
부평LH1(2)단지,40161,5069,4558,4937,4558,132,320
부평SKVIEW해모로아파트,40282,589,517,568,517,21,36
부평SKVIEW해모로아파트,40285,711,665,706,665,5,45
부평감리교회,40148,1152,629,1100,629,52,59
부평경찰서,40468,47162,16958,46908,16958,254,2137
부평경찰서,40794,14242,40163,14152,40163,90,1813
부평구보건소,40372,5885,1968,5739,1968,146,261
부평구보건소,40373,2482,6599,2439,6599,43,302
부평구보건소,40858,2395,2124,2344,2124,51,150
부평구보건소,40890,3483,4296,3418,4296,65,259
부평구자활센터,40651,20735,2003,20267,2003,468,757
부평구자활센터,40658,446,11704,434,11704,12,405
부평구청,40462,36148,26442,35895,26442,253,2086
부평구청,40482,6518,4783,6466,4783,52,376
부평구청,40484,4414,5344,4334,5344,80,325
부평구청,40492,4947,16567,4873,16567,74,717
부평구청·부평세무서,40451,30003,38260,29769,38260,234,2275
부평구청역,40841,20701,4677,20622,4677,79,845
부평기적의도서관,40497,6775,3694,6621,3694,154,348
부평기적의도서관.삼부한신아파트,40490,3324,3678,3281,3678,43,233
부평남부역,40169,3812,5430,3770,5430,42,308
부평남부역입구,40170,6548,2908,6484,2908,64,315
부평남초등학교,40141,3775,2397,3644,2397,131,205
부평남초등학교앞,40136,2668,3641,2584,3641,84,210
부평농장,39772,209,772,209,772,0,32
부평농장사무소,39483,1581,2287,1560,2287,21,128
부평농장의원입구,39494,252,618,245,618,7,29
부평도서관,40082,1509,2968,1454,2968,55,149
부평도서관,40084,1691,2671,1609,2671,82,145
부평동중,40406,3032,2630,2983,2630,49,188
부평동중,55009,3196,2508,3157,2508,39,190
부평래미안아파트,40437,2458,3666,2398,3666,60,204
부평래미안아파트,40438,5848,2052,5715,2052,133,263
부평북초등학교,40656,1757,657,1711,657,46,80
부평북초등학교,40657,750,3638,722,3638,28,146
부평사거리,40073,2470,5710,2405,5710,65,272
부평사거리,40074,12181,7753,12002,7753,179,664
부평사거리,40887,1595,5128,1476,5128,119,224
부평삼거리,39489,11963,9796,11761,9796,202,725
부평삼거리역,39491,4924,2006,4881,2006,43,231
부평삼거리역,40066,11744,9978,11537,9978,207,724
부평샬레아파트(세일고등학교),40260,1979,7700,1930,7700,49,322
부평샬레아파트(세일고등학교),40263,5533,2145,5419,2145,114,255
부평서중,40092,653,736,634,736,19,46
부평서중,40095,343,756,339,756,4,36
부평시장,40262,59187,28839,58323,28839,864,2934
부평시장,40264,23954,38000,23656,38000,298,2065
부평시장,40265,13516,7215,13199,7215,317,691
부평시장,40283,18391,11071,18009,11071,382,982
부평시장,40290,10477,8614,10298,8614,179,636
부평시장(가구의거리),40295,28940,25351,27855,25351,1085,1809
부평시장(가구의거리),40296,33072,10308,32199,10308,873,1446
부평시장(당약국),40303,1330,1394,1313,1394,17,90
부평시장(용갈비),40344,6487,539,6179,539,308,234
부평시장(한남프라자),40259,15167,10259,14718,10259,449,847
부평시장(한라비발디),40328,5867,2307,5653,2307,214,272
부평시장(한라비발디),40336,10110,16903,10000,16903,110,900
부평시장역,40361,19055,52961,18688,52961,367,2400
부평시장역(부평대로우체국),40368,37006,15507,36570,15507,436,1750
부평시장입구,40288,5035,9367,4920,9367,115,480
부평시장입구(2번출구),40309,9319,10826,9032,10826,287,671
부평아트센터,40078,2183,1389,2155,1389,28,119
부평아트센터,40709,1476,3244,1438,3244,38,157
부평여자고등학교,40365,3495,1385,3417,1385,78,162
부평여자고등학교,40410,7078,7112,6976,7112,102,473
부평여자고등학교,40793,8497,8221,8335,8221,162,557
부평여자중학교,40342,244,483,236,483,8,24
부평여자중학교,40726,257,502,255,502,2,25
부평역,40190,9115,46023,8951,46023,164,1837
부평역,40209,58817,56993,58000,56993,817,3860
부평역,40226,25134,17413,24959,17413,175,1418
부평역,40228,39131,40083,38470,40083,661,2640
부평역,40234,17414,42035,17085,42035,329,1981
부평역,40237,14450,5917,14222,5917,228,678
부평역,40239,9395,9894,9280,9894,115,642
부평역(12번출구),40781,35918,66818,35371,66818,547,3424
부평역(27번출구),40224,38640,7162,38223,7162,417,1526
부평역(CU편의점),40192,37404,3745,36919,3745,485,1371
부평역(대한극장),40196,15199,55436,15027,55436,172,2354
부평역(로터스프라자),40246,19880,27843,19431,27843,449,1590
부평역(북인천우체국),40197,50265,32437,49668,32437,597,2756
부평역사박물관,40597,180,500,178,500,2,22
부평역사박물관,40609,843,227,813,227,30,35
부평역사박물관,40798,484,121,476,121,8,20
부평역화성파크드림아파트,40804,996,3400,917,3400,79,146
부평역화성파크드림아파트,40805,4733,1228,4515,1228,218,198
부평우체국,40430,4090,4444,4057,4444,33,284
부평우체국,40432,5699,4311,5592,4311,107,333
부평우체국,40443,293,205,281,205,12,16
부평윤산부인과,40478,578,404,550,404,28,32
부평윤산부인과,40768,394,1855,387,1855,7,74
부평자이,40871,102,1003,100,1003,2,36
부평정수장,40647,1772,3246,1742,3246,30,167
부평제이타워3차지식산업센터,40644,3924,2893,3906,2893,18,227
부평중앙침례교회,40481,140,1161,128,1161,12,43
부평중학교,40402,3791,3767,3662,3767,129,251
부평중학교,40416,3737,3740,3659,3740,78,249
부평코오롱아파트106동,40404,672,1001,657,1001,15,55
부평코오롱하늘채아파트,40357,701,773,688,773,13,49
부평코오롱하늘채아파트,40360,1282,676,1270,676,12,65
부평테크노타워,40615,2152,1383,2146,1383,6,117
부평테크노타워,40616,2124,3675,2090,3675,34,193
부현동초등학교,41175,12177,4203,11947,4203,230,546
부흥로터리,40412,1715,2570,1688,2570,27,142
부흥오거리(부흥아파트),40392,5633,5529,5534,5529,99,372
부흥오거리(부흥아파트),40394,6958,4268,6844,4268,114,374
부흥오거리(소망병원),40374,5858,9169,5718,9169,140,500
부흥오거리(소망병원),40375,15680,9958,15442,9958,238,854
부흥초교,40302,8153,2657,8076,2657,77,360
부흥초등학교,40299,4648,7837,4576,7837,72,416
부흥초등학교,40304,11125,5676,10980,5676,145,560
부흥초등학교·굿케어요양병원,40878,3957,5752,3904,5752,53,323
북구도서관,40469,3209,2793,3093,2793,116,200
북동삼거리,62001,550,83,536,83,14,21
북동삼거리,62002,94,582,91,582,3,22
북변환승센터.구터미널,80080,642,125,642,125,0,25
북변환승센터.구터미널,80081,5,107,0,107,5,3
북성교회,43744,41,24,38,24,3,2
북성교회,43764,17,6,16,6,1,0
북성마을,43136,162,19,148,19,14,6
북성마을,43528,22,92,22,92,0,3
북인천여자중학교,41007,7829,5220,7650,5220,179,434
북인천여자중학교,41008,5876,6639,5811,6639,65,417
북인천여자중학교,41015,857,14672,842,14672,15,517
북인천여자중학교,41016,8268,318,8090,318,178,286
북항다목적부두,89208,38,1851,32,1851,6,62
북항다목적부두,89209,1314,30,1281,30,33,44
북항배후단지입구,89343,49,698,49,698,0,24
북항배후로입구,89414,5,98,0,98,5,3
북항사업소,89210,5,1177,5,1177,0,39
북항사업소,89211,1510,13,1504,13,6,50
북항입구,89304,237,1034,233,1034,4,42
북항입구,89305,214,120,210,120,4,11
분오리어판장,43406,29,33,29,33,0,2
분오리어판장,43495,9,52,9,52,0,2
분오저수지,43493,6,12,5,12,1,0
분오저수지,43509,69,5,64,5,5,2
불로대곡동행정복지센터,42497,1035,1098,1001,1098,34,71
불로대곡동행정복지센터,42498,919,2258,900,2258,19,105
불로중학교,42648,325,1483,318,1483,7,60
불로중학교,42652,642,274,614,274,28,30
불은면주민센터,43035,733,417,705,417,28,38
불은초등학교,43293,65,0,65,0,0,2
불은초등학교,43530,5,31,5,31,0,1
불은파출소,43036,487,648,455,648,32,37
붉은노리삼거리,44112,162,160,151,160,11,10
붉은노리삼거리,44173,19,0,18,0,1,0
뷰티풀파크관리공단,42805,59,0,47,0,12,1
뷰티풀파크관리공단,42806,20,118,5,118,15,4
뷰티풀파크버스공영차고지,42803,169,1036,91,1036,78,40
뷰티풀파크버스공영차고지,42804,3060,109,2890,109,170,105
브라운스톤.엠코타운아파트,40659,12063,15974,11929,15974,134,934
블랙트리캠핑장,44124,21,31,21,31,0,1
블랙트리캠핑장,44174,17,0,17,0,0,0
블루오션골프클럽(앰코코리아),39879,28,776,27,776,1,26
비류마을,38261,1619,1555,1568,1555,51,105
비선삼거리,43113,0,3,0,3,0,0
비선삼거리,43114,16,4,16,4,0,0
비선삼거리,43547,203,345,196,345,7,18
비선삼거리,43596,228,94,208,94,20,10
비재고개,35420,247,36,232,36,15,9
비재고개,35421,58,241,56,241,2,9
비젼교회,40171,3315,2224,3228,2224,87,184
빈정공원,42571,1707,979,1672,979,35,89
빈정공원,42670,508,1169,492,1169,16,55
빈정내사거리,42327,1724,2891,1676,2891,48,153
빈정내사거리,42329,706,400,694,400,12,36
사랑마을벽산.선경.삼익아파트,55030,2567,2199,2560,2199,7,158
사리울삼거리,39128,3545,5671,3384,5671,161,307
사리울삼거리,39131,3141,2374,3023,2374,118,183
사리울중학교,39838,1463,4910,1394,4910,69,212
사리울중학교,39924,7798,1476,7359,1476,439,309
사리울초등학교후문,39713,5503,702,5197,702,306,206
사슴농장,43531,82,0,62,0,20,2
사슴농장,43866,0,29,0,29,0,0
사시미재,35731,48,11,48,11,0,1
사시미재,35732,20,96,20,96,0,3
사업.행정지원센터,35607,391,11,391,11,0,13
사업.행정지원센터,35608,18,546,18,546,0,18
사염공원,89037,2,141,2,141,0,4
사염공원,89038,62,1,61,1,1,2
사우고.김포고(걸포사거리방면),80064,2,758,1,758,1,25
사우고.김포시청,80024,114,2840,114,2840,0,98
사우고교.김포시청(직행),80377,1231,119,1227,119,4,45
사우역.김포고(김포초교방면),80380,871,3544,871,3544,0,147
사우역.김포고(직행),80043,625,9,625,9,0,21
사우역.김포고(직행),80376,3442,429,3438,429,4,129
사원아파트입구,42777,105,100,93,100,12,6
사일로벽화,35163,39,4002,33,4002,6,134
사일로벽화,35167,1851,254,1823,254,28,70
사조해표,42019,1983,1743,1961,1743,22,124
사조해표,42020,678,1222,667,1222,11,63
사직(해나무),43416,2,61,2,61,0,2
사직(해나무),43797,76,0,67,0,9,2
사촌,43597,70,1,61,1,9,2
사촌,43785,0,9,0,9,0,0
삭은다리한국지엠,40524,125,2948,122,2948,3,102
삭은다리한국지엠,40525,3272,1779,3247,1779,25,168
산곡3동행정복지센터,40156,3391,800,3322,800,69,139
산곡교회,40383,8548,2823,8384,2823,164,379
산곡남초등학교,40227,1898,61,1838,61,60,65
산곡동입구(롯데마트),40779,334,1404,323,1404,11,57
산곡동입구(롯데마트),40785,12700,22343,12505,22343,195,1168
산곡동주안빌딩,40313,12861,1991,12770,1991,91,495
산곡동천주교회,40473,22102,12217,21731,12217,371,1143
산곡동천주교회,40476,9555,21495,9293,21495,262,1035
산곡여자중학교,40198,7442,7690,7273,7690,169,504
산곡여자중학교,40203,2557,4110,2520,4110,37,222
산곡여자중학교,40215,43,1792,35,1792,8,61
산곡여자중학교,40216,5053,91,4956,91,97,171
산곡여자중학교(마장로삼거리),40911,1159,1214,1052,1214,107,79
산곡역(1번출구),40420,4804,18977,4731,18977,73,792
산곡역(3번출구),40856,7806,5613,7652,5613,154,447
산곡역(6번출구),40429,9322,15935,9239,15935,83,841
산곡역(7번출구),40425,38312,29567,38141,29567,171,2262
산곡중학교,40320,365,150,351,150,14,17
산곡중학교,40322,147,1595,144,1595,3,58
산곡한양7차,40354,148,8721,141,8721,7,295
산뒤,43235,30,121,26,121,4,5
산뒤,43887,114,23,110,23,4,4
산림조합앞,90234,34,38,30,38,4,2
산림조합앞,90235,26,98,26,98,0,4
산마루집,41497,41,118,40,118,1,5
산마루집,41513,86,0,84,0,2,2
산마을고등학교,43116,0,2,0,2,0,0
산마을고등학교,43599,12,3,12,3,0,0
산문입구,43107,162,168,161,168,1,11
산문입구,43286,246,203,237,203,9,14
산문입구,43899,19,1,19,1,0,0
산문종점,43154,37,75,36,75,1,3
산애들애,43143,4,2,4,2,0,0
산애들애,43492,11,0,11,0,0,0
산업단지사거리,36095,76,3811,73,3811,3,129
산업단지사거리,37460,6526,490,6436,490,90,233
산업용품센타,42524,6102,479,6043,479,59,219
산업용품센타,42525,43,2863,24,2863,19,96
산업용품유통센타23동,36096,231,2018,223,2018,8,74
산업용품유통센타31동,36097,153,1740,151,1740,2,63
산업용품유통센타39동,36099,247,1965,235,1965,12,73
산업용품유통센터,36156,782,4,772,4,10,26
산업용품유통센터1동,36146,2031,324,2020,324,11,78
산업용품유통센터39동,36157,141,4,138,4,3,4
산업용품유통센터C동,36101,1878,65,1844,65,34,64
산우리고개,43337,0,10,0,10,0,0
산우리고개,43850,12,1,12,1,0,0
산음입구,80004,5,481,3,481,2,16
산음입구,80005,88,21,63,21,25,3
산촌마을,43217,7,0,7,0,0,0
산촌마을,43308,28,13,28,13,0,1
산호아파트앞,80059,1749,203,1747,203,2,65
산화고개,43271,184,10,175,10,9,6
산화고개,43388,13,174,12,174,1,6
삼덕아파트,37403,733,890,723,890,10,54
삼덕아파트,37404,596,1016,588,1016,8,53
삼동암리마을회관,43169,0,24,0,24,0,0
삼동암리마을회관,43227,22,0,22,0,0,0
삼두2차아파트,36051,3824,839,3720,839,104,155
삼라마이다스아파트,89317,114,8,114,8,0,4
삼라마이다스아파트,89323,1,83,1,83,0,2
삼목사거리,35088,6,43,6,43,0,1
삼목선착장,35311,1807,2268,1747,2268,60,135
삼목선착장(운서역행),35077,1888,58,1811,58,77,64
삼목선착장입구,35058,0,37,0,37,0,1
삼목선착장입구,35059,7,0,3,0,4,0
삼목초등학교,35310,997,1322,987,1322,10,77
삼목초등학교,35341,2810,969,2664,969,146,125
삼미시장,70172,652,2786,635,2786,17,114
삼미시장,70173,2821,714,2798,714,23,117
삼미타운.e편한세상아파트,40172,5262,5614,5178,5614,84,362
삼보새마을금고,40796,6723,671,6655,671,68,246
삼보아파트,40298,2555,142,2529,142,26,89
삼보아파트,40308,11523,4447,11349,4447,174,532
삼보아파트,40677,7937,381,7809,381,128,277
삼보아파트,40679,467,6701,438,6701,29,238
삼보아파트,40786,4471,16569,4397,16569,74,701
삼보아파트,42350,2885,5943,2779,5943,106,294
삼보아파트,42351,6786,2114,6604,2114,182,296
삼보아파트(계양구청),41205,3964,8651,3885,8651,79,420
삼산경찰서,40584,1094,2850,1056,2850,38,131
삼산경찰서,40766,2010,3192,1987,3192,23,173
삼산고등학교(미래타운3단지),40689,11332,3183,11198,3183,134,483
삼산고등학교(미래타운4단지),40686,5882,8653,5809,8653,73,484
삼산군립어린이집,90171,10,24,10,24,0,1
삼산군립어린이집,90172,29,6,28,6,1,1
삼산글로리병원,40527,7832,7576,7760,7576,72,513
삼산농산물시장,40687,2527,4605,2438,4605,89,237
삼산동차고지,40830,268,19,154,19,114,9
삼산면사무소,90149,37,63,35,63,2,3
삼산면사무소,90150,109,96,101,96,8,6
삼산사거리,40638,5899,10189,5836,10189,63,536
삼산사거리,40690,3151,794,3115,794,36,131
삼산사거리,40691,4947,4210,4848,4210,99,305
삼산사거리(한국아파트),40646,3906,14088,3811,14088,95,599
삼산사거리.한국아파트,40645,5982,1527,5889,1527,93,250
삼산새마을금고,40668,565,6944,552,6944,13,250
삼산서해그랑블,40589,1729,1986,1687,1986,42,123
삼산서해아파트,40613,3199,833,3136,833,63,134
삼산월드체육관,40532,7996,2941,7923,2941,73,364
삼산월드체육관,40535,1402,1446,1376,1446,26,94
삼산월드체육관,40543,51,4083,51,4083,0,137
삼산월드체육관,40571,2472,2762,2426,2762,46,174
삼산월드체육관(삼산주공6단지),40802,1083,2681,1068,2681,15,125
삼산저수지앞,90245,10,4,10,4,0,0
삼산저수지앞,90246,2,0,2,0,0,0
삼산주공1단지,40780,1856,45,1824,45,32,63
삼산주공1단지(상가앞),40908,7866,584,7621,584,245,281
삼산주공4단지,40591,909,1981,898,1981,11,96
삼산주공7단지,40547,7846,6880,7626,6880,220,490
삼산주공7단지,40801,6520,8811,6411,8811,109,511
삼산중학교,40636,1238,809,1187,809,51,68
삼산중학교,40637,1068,1143,1021,1143,47,73
삼산체육관역(호수공원),40536,9727,3158,9621,3158,106,429
삼산체육관역(호수공원),40539,550,5652,526,5652,24,206
삼산체육관역.상동호수공원,55040,435,3613,405,3613,30,134
삼산체육관역.상동호수공원,55041,419,745,417,745,2,38
삼산체육관역.영상문화단지정문,55044,9497,3577,9475,3577,22,435
삼산타운1단지,40588,5305,7710,5243,7710,62,433
삼산타운1단지정문,40585,3084,1095,3041,1095,43,139
삼산타운1단지후문,40611,1331,666,1308,666,23,66
삼산타운1단지후문,40612,450,916,435,916,15,45
삼산타운4단지,40608,3075,777,3041,777,34,128
삼산타운6단지,40580,2374,2361,2314,2361,60,157
삼산타운7단지,40576,2644,2689,2590,2689,54,177
삼산푸른솔마을,40653,33,2321,16,2321,17,78
삼선1리마을회관,90263,1,9,1,9,0,0
삼선1리마을회관,90280,6,1,6,1,0,0
삼선1리삼거리,90262,1,3,1,3,0,0
삼선1리삼거리,90281,6,1,6,1,0,0
삼선2리마을회관,90265,1,26,1,26,0,0
삼선2리마을회관,90278,27,0,27,0,0,0
삼선2리입구,90264,0,9,0,9,0,0
삼선2리입구,90279,11,0,11,0,0,0
삼성바이오로직스,39863,82,1590,74,1590,8,55
삼성바이오로직스,39864,5327,112,5298,112,29,181
삼성바이오로직스,39920,3416,1837,3387,1837,29,175
삼성빌라(종점),37572,48,920,34,920,14,32
삼성아파트,35140,2982,5213,2924,5213,58,273
삼성아파트,38077,5944,5642,5836,5642,108,386
삼성아파트.남인천농협,38125,5435,8088,5340,8088,95,450
삼양감속기,39085,1,8,1,8,0,0
삼양베이커,35131,17,230,17,230,0,8
삼양베이커,35571,57,21,57,21,0,2
삼양사인천1공장,42027,1069,1660,1021,1660,48,90
삼양사인천1공장,42031,2950,3931,2923,3931,27,229
삼영물류,42068,7129,1199,7028,1199,101,277
삼영아파트,37116,4507,1256,4342,1256,165,192
삼영아파트,37279,11972,12706,11726,12706,246,822
삼영아파트,37280,9371,5820,9169,5820,202,506
삼영아파트,42085,12663,6777,12379,6777,284,648
삼영테크,89055,2189,212,2165,212,24,80
삼영테크,89062,30,3184,29,3184,1,107
삼원페트라,39041,507,4010,504,4010,3,150
삼은교회,37111,4845,1844,4747,1844,98,222
삼익.광명아파트,39247,10504,13570,10357,13570,147,802
삼익.광명아파트,39249,16930,8424,16776,8424,154,845
삼익아파트,35136,3200,6743,3048,6743,152,331
삼익아파트.달동네박물관,36017,11486,13016,11248,13016,238,816
삼일산업,39097,2275,1579,2246,1579,29,128
삼정동중소기업협동화단지,57015,1056,1539,1046,1539,10,86
삼정동중소기업협동화단지,57040,1169,825,1163,825,6,66
삼정사거리,57011,672,1101,669,1101,3,59
삼정사거리,57012,814,660,797,660,17,49
삼정초등학교,57008,1166,820,1140,820,26,66
삼정초등학교,57009,508,903,503,903,5,47
삼정프라자,42443,19126,25248,18809,25248,317,1479
삼진금속,39040,3303,357,3282,357,21,122
삼천리1차아파트,41178,3045,2597,2975,2597,70,188
삼천리1차아파트,41179,2857,2223,2796,2223,61,169
삼천리3차아파트,41150,6088,4139,5972,4139,116,340
삼천리3차아파트,41159,4861,5639,4749,5639,112,350
삼천리기계,92017,2,159,2,159,0,5
삼천리기계,92018,161,142,161,142,0,10
삼호제강2공장,39939,163,997,163,997,0,38
삼호제강2공장,39940,739,117,737,117,2,28
삼환1단지아파트,37252,1617,2822,1587,2822,30,147
삼환아파트,38063,1757,2914,1737,2914,20,155
삼환아파트,39296,300,1429,287,1429,13,57
삼환아파트,39299,3364,2264,3312,2264,52,187
삼환아파트,39316,12744,8707,12662,8707,82,715
삼환아파트,39323,999,4031,975,4031,24,167
삼환아파트,39328,8097,7439,8011,7439,86,517
삼환아파트,80058,37,1906,37,1906,0,64
상1리마을회관(창말),90339,2,11,2,11,0,0
상1리마을회관(창말),90342,12,1,12,1,0,0
상1주민지원센터,55074,2821,1738,2776,1738,45,151
상2리마을회관,90337,3,5,3,5,0,0
상2리마을회관,90343,36,1,36,1,0,1
상덕현삼거리,43462,9,20,8,20,1,0
상덕현삼거리,43767,1,7,1,7,0,0
상도중학교,55025,1667,97,1633,97,34,58
상도중학교,55028,333,1636,329,1636,4,65
상동가구,55090,1840,1370,1780,1370,60,107
상동역1번출구.부천터미널소풍.홈플러스,55052,6426,21730,6371,21730,55,938
상동역4번출구.상동지하차도,55048,1444,5937,1425,5937,19,246
상동역5번출구.상동지하차도,55050,14852,2984,14689,2984,163,594
상동역8번출구세이브존,55056,11357,4791,11270,4791,87,538
상사마을,25027,73,226,69,226,4,9
상수도사업본부(스마트타운),37375,4852,8275,4734,8275,118,437
상수도사업본부(스마트타운),37380,4641,11220,4516,11220,125,528
상야동,41436,1475,1405,1460,1405,15,96
상야동,41437,1334,1764,1331,1764,3,103
상용리마을회관,90038,0,54,0,54,0,1
상용리마을회관,90039,90,1,86,1,4,3
상용진료소앞,90004,19,83,19,83,0,3
상용진료소앞,90005,89,10,80,10,9,3
상인천중학교,39537,355,112,350,112,5,15
상인천초등학교,39340,1031,569,997,569,34,53
상인천초등학교,39345,335,1192,333,1192,2,50
상정고,40069,14297,3796,14057,3796,240,603
상정고,40070,5198,13479,5157,13479,41,622
상정중학교,40059,5469,6929,5300,6929,169,413
상주(상리),90331,35,19,34,19,1,1
상주민지원센터.삼광교회,55029,1114,3691,1102,3691,12,160
상주민지원센터.삼광교회,55031,5137,500,5067,500,70,187
상촌,43152,33,17,30,17,3,1
상촌,43347,31,65,28,65,3,3
새꾸지마을,90133,29,24,29,24,0,1
새꾸지마을,90134,27,31,27,31,0,1
새마을,43471,0,6,0,6,0,0
새마을,43702,10,1,7,1,3,0
새마을금고,36053,2547,1137,2488,1137,59,122
새마을금고,40125,1099,1389,1070,1389,29,82
새마을금고,40126,1901,258,1814,258,87,71
새마을금고,40131,1138,3809,1113,3809,25,164
새마을금고,40746,75,854,67,854,8,30
새말사거리,41009,5307,2543,5229,2543,78,261
새말사거리,41010,144,3324,117,3324,27,115
새말사거리,41012,1437,3777,1399,3777,38,173
새말사거리,41013,4045,2672,3999,2672,46,223
새말사거리,41638,906,1897,888,1897,18,93
새봄초등학교,38679,2221,4273,2197,4273,24,216
새봄초등학교·송도파크레인(후문),38678,5202,1914,5138,1914,64,237
새사미아파트,41582,526,410,514,410,12,31
새소망교회,40850,1992,11,1951,11,41,66
새소망교회,40917,3,325,0,325,3,10
새안의원,37255,9850,11100,9650,11100,200,698
새안의원,37256,15509,6444,15292,6444,217,731
새한아파트,37046,4956,2514,4826,2514,130,249
색동원 앞,43161,7,9,6,9,1,0
색동원 앞,43215,4,2,4,2,0,0
샘말,43444,12,16,12,16,0,0
샘말,43782,57,8,51,8,6,2
샛말,43994,3,21,3,21,0,0
샛말,43995,6,16,6,16,0,0
생산기술연구원,38354,309,866,301,866,8,39
생설미,43746,414,235,395,235,19,21
생설미입구,43125,1,9,1,9,0,0
생설미입구,43607,11,1,10,1,1,0
생설미입구,43608,1,57,0,57,1,1
샬롬원입구,90293,8,10,8,10,0,0
샬롬원입구,90297,1,0,1,0,0,0
서곶지구대,42338,12050,8027,11766,8027,284,669
서곶지구대,42339,11774,10037,11573,10037,201,727
서교동,23037,120,4318,120,4318,0,147
서교동,23038,11277,188,11254,188,23,382
서구국민체육센터,42776,800,3914,788,3914,12,157
서구문화회관,42212,1593,2461,1556,2461,37,135
서구문화회관,42213,3428,1116,3366,1116,62,151
서구보건소,42283,4826,3870,4634,3870,192,289
서구보건소,42285,4185,4913,4059,4913,126,303
서구영어마을,42448,6052,4507,5969,4507,83,351
서구영어마을,42449,5069,8957,4922,8957,147,467
서구청역(1번출구),42289,4514,4589,4478,4589,36,303
서구청역(3번출구),42284,1405,796,1382,796,23,73
서구청역(4번출구),42296,2728,2691,2639,2691,89,180
서남촌,43151,10,3,10,3,0,0
서남촌,43640,6,7,6,7,0,0
서당골,35676,17,36,17,36,0,1
서당골,35702,35,41,35,41,0,2
서두머리,43212,22,5,22,5,0,0
서두머리,43336,6,13,6,13,0,0
서림초등학교,36036,6,784,4,784,2,26
서림초등학교,36047,13653,1279,13543,1279,110,497
서릿목,35418,134,469,134,469,0,20
서릿목,35419,476,118,448,118,28,19
서면초등학교,38384,1713,1538,1672,1538,41,108
서문안,43385,20,107,20,107,0,4
서문안,43584,218,17,187,17,31,7
서문안주유소,43965,126,11,124,11,2,4
서문안주유소,43966,17,226,17,226,0,8
서부경찰서,42286,606,858,602,858,4,48
서부공단입구,42299,3259,4075,3238,4075,21,244
서부공단입구,42301,5678,1218,5635,1218,43,229
서부산업단지,89035,36,48,36,48,0,2
서부산업단지,89036,48,372,39,372,9,14
서사체험학습장,43487,20,16,20,16,0,1
서사체험학습장,43712,14,9,14,9,0,0
서성,43234,14,168,12,168,2,6
서성,43362,227,35,211,35,16,8
서운교,41114,734,5092,714,5092,20,194
서운교,41115,4515,367,4450,367,65,162
서운도서관,41099,1724,248,1711,248,13,65
서운도서관,41102,191,1887,185,1887,6,69
서운동,41356,8347,3217,8083,3217,264,385
서운동성당,41207,1442,2281,1288,2281,154,124
서운일반산업단지,41660,657,3,657,3,0,22
서운일반산업단지(맞은편),41661,137,3,135,3,2,4
서운일반산업단지입구,41646,525,3490,523,3490,2,133
서운일반산업단지입구(맞은편),41647,1450,1059,1449,1059,1,83
서운중고등학교,41109,212,842,206,842,6,35
서운중고등학교,41111,706,567,691,567,15,42
서울경금속,39039,317,3250,313,3250,4,118
서울방화초등학교,25028,48,23,40,23,8,2
서울역,11013,21330,12904,21210,12904,120,1141
서원아파트,37095,1531,1154,1473,1154,58,89
서인천가구단지,42017,891,3034,882,3034,9,130
서인천가구단지,42028,3704,2925,3640,2925,64,220
서인천가구단지,42800,509,129,498,129,11,21
서인천고등학교,42346,4560,5086,4467,5086,93,321
서인천농협,42275,1456,561,1411,561,45,67
서인천농협,42277,257,877,250,877,7,37
서인천세무서,89044,381,79,318,79,63,15
서인천세무서(중),89275,1616,1998,1603,1998,13,120
서인천세무서(중),89276,915,1715,910,1715,5,87
서인천자동차검사소,42640,1199,3195,1197,3195,2,146
서인천자동차검사소,42641,5376,1811,5304,1811,72,239
서창119안전센터,39900,10671,2872,10488,2872,183,451
서창119안전센터,39899,4771,9793,4725,9793,46,485
서창공영차고지,39871,8898,145,8587,145,311,301
서창공영차고지,39872,2646,6076,2125,6076,521,290
서창도서관,39893,1567,1908,1524,1908,43,115
서창도서관,39894,1913,1595,1900,1595,13,116
서창도서관입구,39956,171,1872,166,1872,5,68
서창도서관입구,39957,2771,948,2729,948,42,123
서창동화원,39619,148,892,147,892,1,34
서창동화원,39620,585,373,581,373,4,31
서창베라체아파트후문,39895,252,92,241,92,11,11
서창베라체아파트후문,39896,20,481,20,481,0,16
서창센트라스아파트후문,39916,6366,629,6354,629,12,233
서창센트라스아파트후문,39917,922,3718,918,3718,4,154
서창센트럴푸르지오,39811,3989,315,3941,315,48,143
서창센트럴푸르지오,39812,357,3191,345,3191,12,118
서창센트럴푸르지오,39903,14686,7360,14424,7360,262,734
서창센트럴푸르지오,39904,12918,13896,12712,13896,206,893
서창이편한세상1002동,39905,12575,7905,12361,7905,214,682
서창이편한세상1002동,39906,7565,13198,7454,13198,111,692
서창이편한세상정문,39854,601,13981,567,13981,34,486
서창이편한세상정문,39855,14067,557,13764,557,303,487
서창퍼스트뷰후문,39777,11245,2861,11085,2861,160,470
서창퍼스트뷰후문맞은편,39778,1624,9947,1603,9947,21,385
서창휴먼시아12단지,39897,2782,178,2714,178,68,98
서창휴먼시아12단지,39898,271,2082,267,2082,4,78
서초구청,22129,307,50,307,50,0,11
서초동삼성아파트,22140,18,115,18,115,0,4
서초아트자이아파트,31050,4907,12038,4904,12038,3,564
서초역1번출구,31007,11043,28594,11039,28594,4,1321
서초힐스아파트,22286,810,1584,808,1584,2,79
서한리구마을회관,90294,14,14,14,14,0,0
서한리구마을회관,90296,10,0,10,0,0,0
서한리마을회관,90295,18,17,18,17,0,1
서해5도특별경비단,35098,1289,76,1262,76,27,45
서해그랑블,39621,1188,349,1188,349,0,51
서해그랑블,40828,2103,301,1965,301,138,80
서해그랑블,42789,3665,8942,3487,8942,178,420
서해그랑블,42790,7578,2921,7316,2921,262,349
서해그랑블,42912,4590,765,4463,765,127,178
서해그랑블1단지아파트,38604,753,28,744,28,9,26
서해그랑블1단지아파트,38605,50,550,50,550,0,20
서해그랑블3단지아파트,38725,295,25,292,25,3,10
서해그랑블3단지아파트,38726,17,339,17,339,0,11
서해그랑블아파트후문,39973,2214,2243,2175,2243,39,148
서해그랑블아파트후문,39974,2548,3141,2485,3141,63,189
서해그랑블후문,40610,61,962,58,962,3,34
서해수산연구소,35007,155,12,152,12,3,5
서해수산연구소,35008,3,222,3,222,0,7
서해아파트,38164,2721,681,2691,681,30,113
서해아파트,38169,780,2199,768,2199,12,99
서해아파트,41181,1567,2371,1518,2371,49,131
서해아파트,41182,3143,1533,3061,1533,82,155
서해아파트,42354,3483,8979,3393,8979,90,415
서해아파트,42355,14774,3913,14424,3913,350,622
서홍의입구,43446,1,8,1,8,0,0
서홍의입구,43796,24,5,23,5,1,0
서화초등학교(도화e편한세상),37438,12216,7430,12000,7430,216,654
서화초등학교(도화e편한세상),37623,10059,9264,9887,9264,172,644
서흥초등학교,36071,7859,3345,7603,3345,256,373
서흥초등학교,36116,787,289,743,289,44,35
서흥초등학교,36117,306,2322,295,2322,11,87
석건연립,37051,1809,6234,1789,6234,20,268
석남고가교입구사거리,42655,22013,9246,21866,9246,147,1041
석남고가사거리,42145,19315,15944,18865,15944,450,1175
석남고가사거리,42151,22041,16455,21741,16455,300,1283
석남금호어울림아파트101동,42656,4196,8459,4157,8459,39,421
석남도서관,42182,979,2081,969,2081,10,102
석남동차고지,89156,1205,23,1073,23,132,40
석남서초등학교,42108,4884,3120,4848,3120,36,266
석남신사거리,42149,2551,1962,2487,1962,64,150
석남신사거리,42150,2400,2901,2287,2901,113,176
석남역(5번출구),42577,21098,37484,20779,37484,319,1952
석남중앙교회,42138,3038,1824,2945,1824,93,162
석남중학교,42126,8046,6320,7851,6320,195,478
석남중학교,42128,7443,7238,7183,7238,260,489
석남초등학교,42165,11330,3496,10982,3496,348,494
석남초등학교,42167,3527,9240,3475,9240,52,425
석락아파트,37241,12601,9279,12298,9279,303,729
석락아파트,37244,2629,4383,2527,4383,102,233
석모1리마을회관,90145,30,9,28,9,2,1
석모1리마을회관,90146,5,26,5,26,0,1
석모대교(석모리방향),90137,1,31,1,31,0,1
석모대교(석모리방향),90138,32,15,32,15,0,1
석모대교(석포리방향),90139,23,2,23,2,0,0
석모대교(석포리방향),90140,18,72,18,72,0,3
석모대교(외포리방향),90121,3,79,3,79,0,2
석모대교(외포리방향),90122,35,22,33,22,2,1
석모대교전망대,90249,11,20,11,20,0,1
석모대교전망대,90250,10,11,10,11,0,0
석모도미네랄온천,90163,66,49,66,49,0,3
석모도미네랄온천,90164,14,48,14,48,0,2
석모도수목원입구(삼산초등학교),90143,23,23,23,23,0,1
석모도수목원입구(삼산초등학교),90144,58,37,53,37,5,3
석모도자연휴양림입구,90151,10,10,10,10,0,0
석모도자연휴양림입구,90152,8,16,8,16,0,0
석바위,37365,26336,19888,25902,19888,434,1540
석바위,37370,54540,43918,53697,43918,843,3281
석바위시장,37378,2377,6749,2313,6749,64,304
석바위시장,37381,25078,24524,24695,24524,383,1653
석바위시장,37382,22884,20389,22558,20389,326,1442
석바위시장,37384,5218,3994,5091,3994,127,307
석바위시장,37544,3145,5277,3097,5277,48,280
석바위시장역,37373,4268,5055,4188,5055,80,310
석바위시장역,37374,3809,4130,3762,4130,47,264
석산,43375,29,120,28,120,1,4
석산,43833,39,24,36,24,3,2
석산로,92051,900,398,871,398,29,43
석산로,92052,352,617,344,617,8,32
석암초등학교,37412,4063,4058,3970,4058,93,270
석암초등학교앞,37407,14388,8025,14108,8025,280,747
석정여자고등학교,39416,1704,293,1654,293,50,66
석정여자고등학교,39418,111,1814,108,1814,3,64
석조여래입상앞,43663,0,26,0,26,0,0
석조여래입상앞,43692,86,2,85,2,1,2
석천사거리,39308,803,781,778,781,25,52
석천사거리역,39317,4010,6797,3925,6797,85,360
석천사거리역,39320,2839,3229,2778,3229,61,202
석천시장,39502,767,4476,708,4476,59,174
석포리마을회관,90191,43,8,43,8,0,1
석포리마을회관,90192,3,43,3,43,0,1
석포항,90203,57,45,42,45,15,3
선경그린빌라,42307,2390,1835,2329,1835,61,140
선경그린빌라,42541,34,690,34,690,0,24
선경아파트,40238,7523,1950,7480,1950,43,315
선광,38542,5,341,5,341,0,11
선광,38543,208,17,206,17,2,7
선녀바위유원지,35004,992,15,988,15,4,33
선녀바위유원지,35006,149,1062,145,1062,4,40
선녀바위해수욕장,35484,2158,174,2141,174,17,77
선녀바위해수욕장,35485,101,1900,101,1900,0,66
선동,43248,0,14,0,14,0,0
선동,43886,27,1,25,1,2,0
선두1리,43009,309,76,299,76,10,12
선두1리,43099,29,268,28,268,1,9
선두4리마을회관,43242,23,4,23,4,0,0
선두4리마을회관,43644,4,18,4,18,0,0
선두5리어판장입구,90131,5,13,5,13,0,0
선두5리어판장입구,90132,26,11,26,11,0,1
선릉역,23218,1655,7,1655,7,0,55
선릉역,23259,6,2636,6,2636,0,88
선린감리교회,40043,2903,1885,2850,1885,53,159
선린감리교회,40047,3862,5348,3809,5348,53,307
선바위역,66001,24163,765,24132,765,31,830
선바위역,66002,1524,40022,1522,40022,2,1384
선수,43433,6,15,6,15,0,0
선수,43483,11,11,10,11,1,0
선수여객선착장,43429,374,226,340,226,34,20
선수여객선착장,43479,23,78,23,78,0,3
선수촌사거리,39889,199,710,169,710,30,30
선수촌사거리,39890,523,370,485,370,38,29
선원면사무소앞,90067,0,18,0,18,0,0
선원면사무소앞,90068,6,6,5,6,1,0
선원면주민센터,43042,285,400,277,400,8,22
선원면주민센터,43070,446,227,403,227,43,22
선원사,43305,0,11,0,11,0,0
선원사,43742,12,10,7,10,5,0
선원사초입,43307,9,1,5,1,4,0
선원사초입,43756,4,12,4,12,0,0
선원초등학교,43044,39,122,38,122,1,5
선원초등학교,43045,165,67,159,67,6,7
선유고등학교,28017,14098,566,14077,566,21,488
선유고등학교,28018,648,13440,644,13440,4,469
선재대교,44085,6,0,6,0,0,0
선재대교,44175,4,5,4,5,0,0
선재대교입구,44005,61,791,60,791,1,28
선재대교입구,44006,1077,104,1059,104,18,39
선재바다낚시터,44146,1,0,1,0,0,0
선재바다낚시터,44176,0,2,0,2,0,0
선주삼거리,41481,0,101,0,101,0,3
선주삼거리,41502,5,3,5,3,0,0
선주지교회,41482,32,79,30,79,2,3
선주지교회,41503,7,2,7,2,0,0
선주지다리,41480,0,36,0,36,0,1
선주지다리,41501,2,1,1,1,1,0
선주지회차지,41483,54,74,53,74,1,4
선학동행정복지센터.정광아파트,38297,1289,1117,1276,1117,13,80
선학사거리,38295,1113,4659,1053,4659,60,192
선학아파트,38232,6801,1092,6767,1092,34,263
선학아파트,38343,2884,10283,2819,10283,65,438
선학어린이집,38300,2032,2011,1990,2011,42,134
선학역,38305,36545,17653,36325,17653,220,1806
선학역(1번출구),38306,22241,26536,22094,26536,147,1625
선학중학교,38283,770,942,741,942,29,57
선학체육관(하키경기장),38308,1961,1377,1913,1377,48,111
선학체육관(하키경기장),38309,1521,3311,1501,3311,20,161
선행리입구,43908,8,68,7,68,1,2
선행리입구,43909,44,1,43,1,1,1
설호아파트,43378,38,59,38,59,0,3
설호아파트,43618,78,74,70,74,8,5
성강지식산업센터,39837,528,697,524,697,4,40
성경,43603,139,14,137,14,2,5
성경,43771,18,182,18,182,0,6
성리중학교,39969,46,14,45,14,1,2
성리중학교,39979,0,117,0,117,0,3
성리초등학교,39200,21624,20649,21193,20649,431,1409
성리초등학교,39201,9924,15886,9779,15886,145,860
성문교회,39462,518,14,512,14,6,17
성문아파트,39591,4360,1740,4311,1740,49,203
성문아파트(문화연립),39257,3152,4303,3079,4303,73,248
성민병원,42159,16339,15598,15811,15598,528,1064
성민병원,42162,15399,18008,14983,18008,416,1113
성보공업,42007,2310,2241,2259,2241,51,151
성산교회,40572,1351,7791,1251,7791,100,304
성신아크릴산업,89313,185,0,178,0,7,6
성신아크릴산업,89327,0,146,0,146,0,4
성웅아파트,42048,3836,2663,3794,2663,42,216
성웅아파트,42051,4153,2903,4109,2903,44,235
성원기계,92016,918,1471,908,1471,10,79
성원빌딩.우편취급국,37425,12056,6089,11898,6089,158,604
성원아파트,70022,2053,6,2022,6,31,68
성일산업,39787,905,1413,899,1413,6,77
성일산업,39788,1034,725,1030,725,4,58
성일아파트후문앞,40311,813,430,797,430,16,41
성지아파트,38017,22124,39512,21964,39512,160,2054
성지아파트,41025,5584,2978,5453,2978,131,285
성지초등학교,41033,2105,3895,2016,3895,89,200
성지초등학교,41034,3058,1836,3021,1836,37,163
성터지,43038,279,94,260,94,19,12
성터지,43039,90,236,90,236,0,10
성호공원,38748,532,974,522,974,10,50
성호아파트,38204,11643,10784,11368,10784,275,747
세광2차아파트,43758,1649,537,1581,537,68,72
세광2차아파트,43857,384,1115,365,1115,19,49
세광아파트,43049,1031,1804,1007,1804,24,94
세광아파트,43050,2321,686,2268,686,53,100
세농푸드,41510,54,1,54,1,0,1
세우산업,39094,1671,4482,1661,4482,10,205
세월천사거리,40489,4650,9732,4531,9732,119,479
세일빌라.인천산림조합,39158,2407,1219,2369,1219,38,120
세일빌라.인천산림조합,39159,5050,3848,5024,3848,26,296
세현정공,39033,881,2083,880,2083,1,98
세화파렛텍,90216,46,24,46,24,0,2
센타빌딩,39902,11854,12809,11629,12809,225,822
센트럴공원,38490,955,2759,945,2759,10,123
센트럴파크역,38397,10182,847,10173,847,9,367
센트럴파크역,38574,1372,2636,1362,2636,10,133
센트럴파크푸르지오아파트,38544,1691,1271,1663,1271,28,98
센트럴파크푸르지오아파트,38545,889,1549,842,1549,47,81
셀트리온(주),38319,198,655,193,655,5,28
셀트리온(주)앞,38513,479,259,462,259,17,24
셀트리온2공장앞,38474,606,657,597,657,9,42
셀트리온2공장앞,38475,1000,490,990,490,10,49
소게,43185,0,106,0,106,0,3
소게,43243,77,9,73,9,4,2
소구월사거리,39266,5551,12297,5440,12297,111,594
소구월사거리,39268,4798,3701,4517,3701,281,283
소나무,43396,55,0,54,0,1,1
소나무,43805,2,35,2,35,0,1
소담(장미)마을입구,90236,0,1,0,1,0,0
소담(장미)마을입구,90237,1,10,1,10,0,0
소동,43412,134,0,126,0,8,4
소동,43829,2,149,2,149,0,5
소래도서관,39829,20,896,6,896,14,30
소래산등산로입구,39770,3,60,3,60,0,2
소래산등산로입구,39771,39,3,39,3,0,1
소래산입구,39668,32,709,32,709,0,24
소래산입구,39670,1177,107,1173,107,4,42
소래역사관,39816,288,1241,286,1241,2,50
소래역사관,39817,1995,166,1963,166,32,72
소래초등학교,39615,223,313,220,313,3,17
소래포구,39815,1323,122,1301,122,22,48
소래포구,39818,164,2721,159,2721,5,96
소래포구역,39647,3481,1607,3428,1607,53,169
소래포구역,39648,1801,4716,1754,4716,47,217
소래포구역,39710,3214,1107,3074,1107,140,144
소래포구역앞,92063,1581,1005,1560,1005,21,86
소래포구역종점,39793,631,34,571,34,60,22
소래포구입구,70009,1170,176,1138,176,32,44
소래포구입구(논현푸르지오A),39109,448,1273,436,1273,12,57
소래포구입구(논현푸르지오A),39114,307,166,300,166,7,15
소래풍림아파트,39122,2862,947,2763,947,99,126
소리공원(하모니로),38721,266,726,263,726,3,33
소리공원(하모니로),38722,296,264,276,264,20,18
소망탑빌라,40116,2,289,2,289,0,9
소방대앞,90022,10,61,7,61,3,2
소방대앞,90023,178,9,165,9,13,6
소산서원,70011,195,800,190,800,5,33
소산서원,70012,352,411,315,411,37,25
소장전,43996,6,32,6,32,0,1
소장전,43997,13,8,13,8,0,0
소촌마을,41662,76,8,75,8,1,2
속아지,43344,26,0,24,0,2,0
속아지,43848,1,30,0,30,1,1
솔밭마을,38193,783,347,767,347,16,37
솔빛마을,36034,9067,9041,8869,9041,198,603
솔빛마을,36037,6012,6605,5829,6605,183,420
솔빛마을주공아파트,36049,10569,7463,10283,7463,286,601
솔빛마을주공아파트,36050,10019,12038,9849,12038,170,735
솔빛주공2단지,36045,1041,825,1026,825,15,62
솔안공원,38348,11191,6615,10984,6615,207,593
솔정,43526,30,7,14,7,16,1
솔정,43871,7,13,3,13,4,0
솔정1리마을회관,90085,0,6,0,6,0,0
솔정1리마을회관,90086,4,0,4,0,0,0
솔정마을,43129,19,4,11,4,8,0
솔정마을,43811,24,0,20,0,4,0
솔정마을,43872,5,9,4,9,1,0
솔정마을,90108,0,2,0,2,0,0
솔정정미소,43130,17,34,17,34,0,1
솔정정미소,43134,79,9,54,9,25,2
솔터마을입구,80327,1153,311,1145,311,8,48
솔터마을입구,80336,1386,1254,1371,1254,15,88
솔펜션,44143,2,8,2,8,0,0
솔펜션,44177,11,2,10,2,1,0
송곡촌,43439,11,34,11,34,0,1
송곡촌,43815,78,16,78,16,0,3
송내고교입구,11014,74,359,72,359,2,14
송내고교입구,11015,680,149,680,149,0,27
송내고등학교,40219,2552,2613,2467,2613,85,172
송내남부역,40761,48,1339,48,1339,0,46
송내역.로데오거리,55267,4938,26841,4866,26841,72,1059
송내역.영화의거리,55263,24098,6326,23774,6326,324,1014
송내역남부,56002,97368,37873,96926,37873,442,4508
송내역남부,56005,110997,97845,110061,97845,936,6961
송담초등학교,38667,1852,664,1807,664,45,83
송담초등학교,38668,836,1766,820,1766,16,86
송도1동행정복지센터,38012,5374,12962,5292,12962,82,611
송도2동행정복지센터,38492,4690,2663,4623,2663,67,245
송도2동행정복지센터,38588,701,1971,680,1971,21,89
송도MTB파크,38746,79,144,79,144,0,7
송도SK뷰(101동),38635,531,111,510,111,21,21
송도SK뷰(105동),38632,45,236,35,236,10,9
송도SK뷰(105동),38633,865,109,855,109,10,32
송도sk뷰,38707,1109,2455,1065,2455,44,118
송도sk뷰,38708,311,1515,295,1515,16,60
송도고입구,38215,3177,3343,3009,3343,168,217
송도고입구,38221,2960,1169,2879,1169,81,137
송도공영차고지,38472,421,37,353,37,68,15
송도국제교입구,38597,99,0,99,0,0,3
송도글로벌캠퍼스푸르지오아파트,38711,773,520,756,520,17,43
송도누리공원,38663,2978,3907,2915,3907,63,229
송도누리공원,38664,787,2814,761,2814,26,120
송도달빛축제공원역,38696,13806,2834,13682,2834,124,554
송도달빛축제공원역,38697,2251,12457,2227,12457,24,490
송도더삽그린워크(3차),38530,96,239,93,239,3,11
송도더샵그린스퀘어,39843,4584,1647,4537,1647,47,207
송도더샵그린워크,38526,1400,542,1370,542,30,64
송도더샵그린워크2차,38493,2304,3539,2260,3539,44,194
송도더샵그린워크3차18블럭,38719,173,624,163,624,10,26
송도더샵마스터뷰21단지,38578,3305,449,3173,449,132,125
송도더샵마스터뷰22단지,38693,788,296,775,296,13,36
송도더샵마스터뷰22단지(2202동),38698,52,215,49,215,3,8
송도더샵마스터뷰22단지(2202동),38712,203,458,203,458,0,22
송도더샵마스터뷰22단지(정문),38694,290,948,276,948,14,41
송도더샵마스터뷰22단지(하행),38695,246,824,222,824,24,35
송도더샵마스터뷰23단지,38441,3844,3567,3691,3567,153,247
송도더샵마스터뷰23단지,38442,411,6020,380,6020,31,214
송도더샵마스터뷰23단지(정문),38692,1130,189,1124,189,6,43
송도더샵센트럴시티,39842,2797,4013,2698,4013,99,227
송도더샵센트럴시티.글로벌캠퍼스푸르지오,38647,3909,1024,3885,1024,24,164
송도더샵퍼스트월드,38589,921,1105,904,1105,17,67
송도더샵퍼스트월드(동문),38013,16149,6214,16032,6214,117,745
송도더샵퍼스트월드(서문),38381,3160,1092,3086,1092,74,141
송도더샵퍼스트월드B동.C동,38425,4328,2045,4267,2045,61,212
송도더샵퍼스트월드D동,38009,1674,1882,1637,1882,37,118
송도더샵퍼스트파크14단지,38560,854,2091,807,2091,47,98
송도더샵퍼스트파크14단지,38577,1778,287,1734,287,44,68
송도더샵퍼스트파크15단지,38559,257,737,246,737,11,33
송도더샵퍼스트파크15단지,38576,645,129,594,129,51,25
송도더샵하버뷰2차,38467,2292,14164,2254,14164,38,548
송도동일하이빌파크포레아파트,38680,3295,1018,3238,1018,57,143
송도라마다호텔앞,38065,2302,4429,2272,4429,30,224
송도라마다호텔앞,38067,12226,8284,11986,8284,240,683
송도랜드마크시티13호근린공원,38738,59,524,58,524,1,19
송도랜드마크시티13호근린공원,38739,223,226,222,226,1,14
송도랜드마크푸르지오시티,38747,16,175,16,175,0,6
송도베르디움더퍼스트후문,39985,991,4133,978,4133,13,170
송도세브란스병원,38651,41,717,41,717,0,25
송도센트럴파크,38452,1046,7037,1044,7037,2,269
송도센트럴파크역,38563,2360,505,2309,505,51,95
송도소방서(송도스마트밸리),39801,2378,2808,2364,2808,14,172
송도스마트밸리,39802,4339,2423,4321,2423,18,225
송도스포츠센터(LNG야구장),39721,1854,1380,1780,1380,74,107
송도아트윈푸르지오,38549,451,526,431,526,20,32
송도아트윈푸르지오,38562,2,246,2,246,0,8
송도에듀포레푸르지오,39921,1213,4782,1190,4782,23,199
송도에듀포레푸르지오후문,39986,4227,517,4189,517,38,158
송도역,38213,2389,6387,2368,6387,21,292
송도역,38505,9488,12014,9328,12014,160,716
송도역,38669,491,1007,487,1007,4,49
송도영남아파트,38224,10912,7422,10761,7422,151,611
송도오션파크베르디움,38642,990,14759,969,14759,21,524
송도요양원,38144,1816,2100,1766,2100,50,130
송도유원지(도로교통공단),38081,10128,12725,9944,12725,184,761
송도유원지(도로교통공단),38088,15809,6932,15364,6932,445,758
송도자이하버뷰,38521,3784,1541,3758,1541,26,177
송도자이하버뷰1단지,38468,16984,2601,16873,2601,111,652
송도자이하버뷰2단지(202동),38488,2812,4003,2620,4003,192,227
송도자이하버뷰2단지(205동),38455,563,580,544,580,19,38
송도자이하버뷰2단지(정문),38465,2080,1246,2056,1246,24,110
송도자이하버뷰2단지(정문),38498,1292,1864,1248,1864,44,105
송도재래시장,38207,5937,8024,5745,8024,192,465
송도재래시장,38210,7705,5634,7515,5634,190,444
송도재래시장,38220,5649,2705,5529,2705,120,278
송도제2차고지,38703,523,20,385,20,138,18
송도제2차고지입구,38735,418,959,354,959,64,45
송도중학교,35155,13481,14713,12734,14713,747,939
송도지웰푸르지오시티,38424,4924,8558,4872,8558,52,449
송도채석장,38175,770,2617,758,2617,12,112
송도체육센터,38699,130,476,126,476,4,20
송도체육센터,38700,390,193,370,193,20,19
송도컨벤시아,38367,1598,6081,1552,6081,46,255
송도컨벤시아,38369,2615,1073,2565,1073,50,122
송도컨벤시아남문,38660,1780,1106,1753,1106,27,96
송도컨벤시아남문,38661,990,1829,967,1829,23,93
송도타임스페이스,38720,760,1390,753,1390,7,71
송도테크노파크IT센터,39929,5273,3953,5259,3953,14,307
송도파크레인동일하이빌,38625,53,84,52,84,1,4
송도파크레인동일하이빌,38626,950,15,941,15,9,32
송도파크레인입구,38538,336,3243,326,3243,10,119
송도파크레인입구,38539,1329,1414,1311,1414,18,91
송도파크자이,38627,960,556,949,556,11,50
송도파크자이,38628,11,793,8,793,3,26
송도파크자이아파트,38638,8514,7518,8220,7518,294,534
송도파크자이아파트정문,38677,1248,5008,1222,5008,26,208
송도푸르지오월드마크,38426,4636,6696,4557,6696,79,377
송도푸르지오하버뷰,38494,3675,4219,3575,4219,100,263
송도풍림아이원1단지,38033,3095,24673,2962,24673,133,925
송도풍림아이원2단지,38025,7784,16030,7406,16030,378,793
송도풍림아이원2단지,38026,9875,4674,9658,4674,217,484
송도풍림아이원2단지,38034,27087,2738,26616,2738,471,994
송도풍림아이원4단지,38032,3404,9151,3256,9151,148,418
송도힐스테이트,38479,14076,6698,13828,6698,248,692
송도힐스테이트5단지,38393,5650,9252,5587,9252,63,496
송도힐스테이트6단지,38554,40,224,40,224,0,8
송동마을.서초힐스아파트,22962,1014,140,1012,140,2,38
송림119안전센터,36165,56,182,53,182,3,7
송림3.5동행정복지센터(재능대정문),36030,1772,7127,1750,7127,22,296
송림4동행정복지센터(재능대후문),36127,150,774,141,774,9,30
송림고가교,37491,1998,1392,1965,1392,33,113
송림고가교,37492,1121,1717,1111,1717,10,94
송림고개(도화신동아아파트),37439,7932,8758,7669,8758,263,556
송림고개(도화신동아아파트),37501,11628,6867,11431,6867,197,616
송림동진로아파트,36154,266,388,264,388,2,21
송림동진로아파트,36155,174,820,168,820,6,33
송림빌라,43316,43,1,42,1,1,1
송림빌라,43775,176,143,163,143,13,10
송림시장,36015,224,288,206,288,18,17
송림오거리,36131,14995,3952,14759,3952,236,631
송림오거리,36132,3599,9327,3502,9327,97,430
송림주공아파트,36171,6,4,6,4,0,0
송림주공아파트,36176,0,3,0,3,0,0
송림주유소,36090,607,438,575,438,32,34
송림체육관,36130,627,51,623,51,4,22
송림체육관,36148,16,334,2,334,14,11
송림체육관후문,36152,53,792,52,792,1,28
송림체육관후문,36153,416,85,415,85,1,16
송림휴먼시아,36124,26,605,19,605,7,21
송림휴먼시아,36125,133,2207,133,2207,0,78
송림휴먼시아정문,36164,57,0,57,0,0,1
송림휴먼시아정문,36180,1,30,1,30,0,1
송마3리,80157,514,30,502,30,12,18
송마3리,80158,35,267,29,267,6,10
송마리입구,80159,34,705,30,705,4,24
송마리입구,80160,478,149,450,149,28,20
송명초등학교,92013,2780,247,2745,247,35,100
송산,43482,95,28,94,28,1,4
송산,43710,42,74,42,74,0,3
송산교회,43956,7,35,7,35,0,1
송산삼거리,43480,80,4,72,4,8,2
송산삼거리,43611,3,48,3,48,0,1
송암박두성생가입구,90396,0,30,0,30,0,1
송암박두성생가입구,90397,2,0,2,0,0,0
송월동동화마을,35189,6777,3662,6495,3662,282,347
송월동동화마을,35190,3767,8446,3658,8446,109,407
송월아파트,35193,3169,653,3072,653,97,127
송월아파트,35194,958,3207,934,3207,24,138
송정역,25184,33,2430,29,2430,4,82
송정역,25185,4339,65,4271,65,68,146
송학둥지아파트,38584,3580,3604,3491,3604,89,239
송학둥지아파트,38585,1795,4202,1716,4202,79,199
송해교회,43384,261,88,254,88,7,11
송해교회,43769,81,252,81,252,0,11
송해면사무소,43708,21,142,19,142,2,5
송해면사무소,43809,115,28,113,28,2,4
송해삼거리,43386,355,45,331,45,24,13
송해삼거리,43819,138,493,128,493,10,21
송해초등학교,43807,13,153,13,153,0,5
송해초등학교,43820,81,32,80,32,1,3
송현시장.수도국산달동네박물관,36019,5580,4886,5298,4886,282,348
송현시장.수도국산달동네박물관,36020,5570,20872,5355,20872,215,881
송현시장.수도국산달동네박물관,36025,33,441,33,441,0,15
송현아파트,36065,5933,3489,5770,3489,163,314
송현아파트,36067,2137,4841,2050,4841,87,232
송현주공아파트,36073,872,2998,853,2998,19,129
송현주공아파트,36080,12057,5603,11680,5603,377,588
송현주공아파트후문,36162,692,2877,676,2877,16,118
쇠골큰말,89318,33,33,33,33,0,2
쇠골큰말,89321,120,10,109,10,11,4
수곡(월곳리),43191,56,0,56,0,0,1
수곡(월곳리),43620,0,32,0,32,0,1
수광티티아이,90215,24,52,24,52,0,2
수도군수지원단(장애인복지관),40825,5824,1528,5695,1528,129,245
수도군수지원단(장애인복지관),40826,38,2187,29,2187,9,74
수림공원,39347,2045,740,1981,740,64,92
수림공원,39351,681,1684,668,1684,13,78
수변로삼거리,40367,1014,515,981,515,33,50
수변로삼거리,40370,2511,4451,2491,4451,20,232
수봉공원,37289,2197,1233,2149,1233,48,114
수봉공원,37569,1106,3813,1080,3813,26,163
수봉공원.인천수봉문화회관입구,37362,13615,6895,13113,6895,502,683
수봉공원.인천수봉문화회관입구,37369,8842,13489,8672,13489,170,744
수봉마을쉼터,37570,3585,3069,3421,3069,164,221
수봉마을쉼터,37571,2290,1871,2247,1871,43,138
수부촌,43041,131,177,131,177,0,10
수산동,39175,387,827,383,827,4,40
수산동,39176,500,609,482,609,18,36
수양관,43245,42,58,42,58,0,3
수양관,43645,52,14,50,14,2,2
수인곡물시장,35134,2346,2672,2264,2672,82,167
수정제입구,90290,5,10,5,10,0,0
수촌,43111,89,1,84,1,5,3
수촌,43358,1,70,1,70,0,2
수출산업단지6공단입구,40009,3551,4556,3491,4556,60,270
수출산업단지6공단입구,40010,2200,2546,2178,2546,22,158
수행마을.홈플러스,80074,627,11,624,11,3,21
수행마을.홈플러스,80075,44,533,44,533,0,19
수현마을,39487,2616,3689,2560,3689,56,210
수현마을,39488,6127,5024,5925,5024,202,371
수협,43059,0,1,0,1,0,0
수협,43060,161,913,157,913,4,35
수협,43062,3197,9461,3107,9461,90,421
수협(인천해양센터),35080,3517,103,3318,103,199,120
수협(인천해양센터),35081,102,5430,102,5430,0,184
순복음교회,37253,9556,26686,9239,26686,317,1208
순복음교회,39181,19532,8182,18834,8182,698,923
순복음교회,40661,11893,5842,11767,5842,126,591
순천향대학병원.부명고,55037,8052,899,7927,899,125,298
숭덕여중고입구,39461,13089,24300,12930,24300,159,1246
숭덕여중고입구,39463,16031,12144,15735,12144,296,939
숭덕여중고입구,39466,7612,1336,7511,1336,101,298
숭뢰2리,43421,77,201,76,201,1,9
숭뢰2리,43704,193,52,188,52,5,8
숭보사입구,40851,162,57,154,57,8,7
숭보사입구,40918,7,103,0,103,7,3
숭의1.3동(극동아파트),37328,923,1399,871,1399,52,77
숭의1.3동(극동아파트),37337,1137,1349,1089,1349,48,82
숭의2동행정복지센터,37563,1638,2087,1625,2087,13,124
숭의교회,37269,17772,11225,17414,11225,358,966
숭의교회,37271,13071,14658,12691,14658,380,924
숭의로터리,37265,6266,18219,6122,18219,144,816
숭의로터리,37266,16258,5282,15967,5282,291,718
숭의로터리,37273,18999,9045,18577,9045,422,934
숭의로터리.도원체육관,37276,9167,14314,8900,14314,267,782
숭의목공예마을앞,37313,8582,7826,8317,7826,265,546
숭의목공예마을앞,37315,5612,6266,5467,6266,145,395
숭의박문아파트,37353,2585,3689,2536,3689,49,209
숭의박문아파트,37354,3428,2191,3336,2191,92,187
숭의보건지소,37532,14244,3837,14039,3837,205,602
숭의역(1번출구),37510,43822,21456,43261,21456,561,2175
숭의역(2번출구),37211,27185,34348,26962,34348,223,2051
숭의역(3번출구),35133,1002,2948,962,2948,40,131
숭의역(4번출구),35135,3257,2480,3193,2480,64,191
숭의초등학교,37296,935,693,895,693,40,54
숭의초등학교,37308,1241,3232,1210,3232,31,149
숭의초등학교입구,37287,1655,1639,1580,1639,75,109
쉐보레인천서비스,40433,1806,4216,1791,4216,15,200
쉐보레출고사무소,89160,1945,25,1900,25,45,65
쉴낙원인천장례식장,41458,1058,1845,1033,1845,25,96
스카이시티자이.화성파크드림,35650,2139,6139,2065,6139,74,275
스타파이브입구,35428,267,28,262,28,5,9
스타파이브입구,35429,27,279,25,279,2,10
스태츠칩팩코리아,35641,2,426,2,426,0,14
스태츠칩팩코리아,35642,345,5,341,5,4,11
스틸랜드,70228,174,505,170,505,4,22
스틸랜드,70229,440,191,440,191,0,21
스포월드골프연습장,42439,79,208,79,208,0,9
스포월드골프연습장,42440,14,120,9,120,5,4
승기천,39169,1131,6619,1099,6619,32,258
승기천,39170,846,4752,830,4752,16,186
시대아파트,38340,16978,13268,16738,13268,240,1008
시리미,43330,56,53,48,53,8,3
시리미,43631,12,0,12,0,0,0
시립가좌테니스장,37581,181,1210,176,1210,5,46
시립가좌테니스장,37582,129,2535,124,2535,5,88
시민공원,37359,13806,4909,13422,4909,384,623
시민공원(문화창작지대)역,37344,20345,18520,20087,18520,258,1295
시민공원(문화창작지대)역,37346,30991,29184,30449,29184,542,2005
시민공원.문화창작지대,37334,17634,30504,17267,30504,367,1604
시민공원.문화창작지대,37468,1623,1670,1576,1670,47,109
시민공원역.포레나미추홀,37319,8424,57358,8268,57358,156,2192
시민공원역.포레나미추홀,37326,79219,17523,78293,17523,926,3224
시민의숲.양재꽃시장,31002,14237,4178,14219,4178,18,613
시민의숲.양재꽃시장,31003,1576,3509,1572,3509,4,169
시장로터리(중앙철재),40261,2487,1891,2458,1891,29,145
시청광장입구,39217,17545,20541,17228,20541,317,1269
시청광장입구,39218,21397,17959,21229,17959,168,1311
시흥대야역.영남아파트,70027,323,1396,319,1396,4,57
시흥대야역.영남아파트,70028,1411,417,1382,417,29,60
시흥보건소,70015,1911,476,1875,476,36,79
시흥보건소,70016,523,1713,515,1713,8,74
시흥영업소,25846,141,63,141,63,0,6
시흥영업소,25847,73,133,73,133,0,6
신골입구,43998,10,53,9,53,1,2
신골입구,43999,56,6,56,6,0,2
신광주유소,43470,6,2,6,2,0,0
신광주유소,43524,4,11,4,11,0,0
신광초등학교,35142,499,391,475,391,24,29
신기.남부종합시장(진흥사거리),37217,49843,28574,48734,28574,1109,2613
신기.남부종합시장(진흥사거리),37219,16243,28417,15817,28417,426,1488
신김포농협대곶지점,80147,52,28,52,28,0,2
신김포농협대곶지점,80148,171,196,162,196,9,12
신논현역,32055,11914,85,11903,85,11,399
신논현역.우신빌딩,31057,49,6860,49,6860,0,230
신당리동촌부락,90090,24,0,24,0,0,0
신당리동촌부락,90091,0,3,0,3,0,0
신당리마을회관,90087,0,3,0,3,0,0
신당리마을회관,90088,1,0,1,0,0,0
신당촌,90114,21,5,21,5,0,0
신대진중앙아파트,41271,3832,3029,3784,3029,48,228
신대진중앙아파트,41274,2199,3585,2180,3585,19,192
신도실업(주),40625,604,1630,599,1630,5,74
신동마을,90253,1,7,1,7,0,0
신동마을,90254,12,15,11,15,1,0
신동아1.2차아파트,37507,10068,6033,9950,6033,118,536
신동아1단지,70038,153,146,139,146,14,9
신동아1단지.한일아파트,70037,165,137,162,137,3,10
신동아3차아파트,37119,12378,16080,12140,16080,238,948
신동아3차아파트,37120,11289,19923,11176,19923,113,1040
신동아3차아파트,37494,11730,5563,11546,5563,184,576
신동아상가,40860,5508,4307,5486,4307,22,327
신동아상가(백운역방면),40068,5594,7524,5464,7524,130,437
신동아아파트,37072,8,1020,7,1020,1,34
신동아아파트,37143,9371,14137,9146,14137,225,783
신동아아파트,37160,6022,7964,5920,7964,102,466
신동아아파트,37525,2445,7934,2363,7934,82,345
신동아아파트,39381,3400,7189,3371,7189,29,352
신동아아파트,39382,17021,6713,16835,6713,186,791
신동아아파트,41349,7213,979,7186,979,27,273
신동아아파트,41350,1582,6660,1567,6660,15,274
신동아아파트(B),37162,11719,10860,11517,10860,202,752
신동아아파트116동,40060,3377,11133,3297,11133,80,483
신동아아파트116동,40859,7990,3010,7949,3010,41,366
신동아아파트3차,37090,10517,1169,10326,1169,191,389
신동아아파트3차,37097,3703,9474,3594,9474,109,439
신동아아파트4차,37121,4859,1664,4787,1664,72,217
신동아아파트4차,37123,2671,3711,2622,3711,49,212
신동아아파트5차,37141,13035,4098,12830,4098,205,571
신동아아파트8차,37135,1440,3326,1415,3326,25,158
신동아아파트8차,37136,5126,1099,5077,1099,49,207
신동양아파트,41202,3307,8161,3292,8161,15,382
신동양아파트,41203,7722,3848,7606,3848,116,385
신라아파트,37277,7226,6819,7062,6819,164,468
신라아파트,37543,1647,4086,1579,4086,68,191
신명보람마을.삼부한신아파트,40511,2314,2761,2273,2761,41,169
신명보람마을.삼부한신아파트,40512,619,911,608,911,11,51
신명스카이뷰,35453,1236,2380,1192,2380,44,120
신명스카이뷰,35456,5930,4853,5781,4853,149,359
신명스카이뷰,42737,181,267,176,267,5,14
신명스카이뷰정문,35455,6011,5907,5873,5907,138,397
신명아파트,42081,8954,12029,8725,12029,229,699
신명아파트.대우3차아파트,70018,379,3112,350,3112,29,116
신명아파트앞,42799,20,1279,19,1279,1,43
신반포역.세화여중고,31033,782,52,781,52,1,27
신봉삼거리,43126,93,11,91,11,2,3
신봉삼거리,43127,67,43,60,43,7,3
신봉삼거리,43463,40,32,31,32,9,2
신봉삼거리,43814,4,23,4,23,0,0
신봉이발관,43458,56,3,54,3,2,1
신봉이발관,43786,1,66,1,66,0,2
신북항고가교,42104,3123,2345,3097,2345,26,182
신북항고가교,42109,2136,2648,2107,2648,29,159
신분당선.강남역4번출구,23572,11175,2590,11168,2590,7,458
신비마을아파트,37164,285,1769,279,1769,6,68
신비마을아파트,37223,5124,7667,5054,7667,70,426
신비마을아파트,37225,6689,4436,6558,4436,131,370
신비마을아파트,37555,322,1273,318,1273,4,53
신비마을아파트(112동),37171,4969,3628,4831,3628,138,286
신삼1리마을회관,43405,128,1,122,1,6,4
신삼1리마을회관,43791,2,110,2,110,0,3
신삼2리마을회관,43400,91,1,85,1,6,3
신삼2리마을회관,43825,14,99,14,99,0,3
신삼리입구,43606,10,13,9,13,1,0
신삼리입구,43801,14,61,14,61,0,2
신선지입구,90346,13,1,5,1,8,0
신선지입구,90347,2,15,2,15,0,0
신선초등학교,35086,6230,11153,6144,11153,86,579
신선초등학교(유림노르웨이숲),35089,6962,3321,6877,3321,85,342
신선초등학교앞,37055,2814,999,2675,999,139,127
신설동,35413,23,52,19,52,4,2
신설동,35416,39,18,39,18,0,1
신설동(3거리),35018,153,14,142,14,11,5
신설동(3거리),35019,20,194,17,194,3,7
신성미소지움,40099,2788,29,2572,29,216,93
신성미소지움,40102,117,2054,24,2054,93,72
신성미소지움,40643,1669,12282,1654,12282,15,465
신성미소지움,40649,6712,2073,6577,2073,135,292
신성미소지움후문,40660,0,403,0,403,0,13
신성성결교회(올림피아병원),39355,12528,8067,12403,8067,125,686
신세계아파트,39383,3132,4813,3058,4813,74,264
신송고등학교,38023,1827,3149,1759,3149,68,165
신송고등학교,38024,3552,2528,3295,2528,257,202
신안실크밸리,35220,801,344,782,344,19,38
신연수역(1번출구),38263,4071,4738,4006,4738,65,293
신연수역(2번출구),38231,2749,648,2743,648,6,113
신연수역(3번출구),38228,5903,4432,5849,4432,54,344
신영자동차,40561,4026,696,3976,696,50,157
신영자동차(종점),40556,5349,2713,5266,2713,83,268
신왕마을,43203,182,2,179,2,3,6
신왕마을,43718,2,105,2,105,0,3
신원기술,39130,29,10,29,10,0,1
신원아침도시오피스텔(홈플러스),39836,5716,5983,5640,5983,76,389
신일교회,39529,4632,6987,4541,6987,91,387
신일아파트,35097,9,8,9,8,0,0
신정1리마을회관,43300,31,9,28,9,3,1
신정1리마을회관,43737,16,9,15,9,1,0
신정삼거리,90111,0,6,0,6,0,0
신정삼거리,90112,3,0,2,0,1,0
신정중학교,38459,959,1244,916,1244,43,73
신정중학교,38555,1592,639,1522,639,70,74
신중동역4번출구.롯데백화점,55226,2098,6798,2095,6798,3,296
신중동역5번출구.중흥중학교,55071,1028,6625,1028,6625,0,255
신중동역6번출구.중흥중학교,55072,3394,699,3389,699,5,136
신지동마을회관,43303,71,55,67,55,4,4
신지동마을회관,43740,66,31,59,31,7,3
신진아파트,41107,25200,13286,24919,13286,281,1282
신창아파트,37010,3740,6390,3323,6390,417,337
신창아파트,37464,5369,2152,5277,2152,92,250
신천동,70048,7287,646,7127,646,160,264
신천동,70049,312,7281,303,7281,9,253
신천삼거리,70013,7224,416,7018,416,206,254
신천삼거리,70014,449,6754,431,6754,18,240
신천역.문화의거리,25364,1021,345,1010,345,11,45
신천역.문화의거리,70174,238,1055,225,1055,13,43
신천연합병원,70175,84,705,84,705,0,26
신천연합병원,70231,706,207,690,207,16,30
신촌,43146,29,0,29,0,0,0
신촌,43432,19,16,19,16,0,1
신촌,43459,226,14,218,14,8,8
신촌,43510,0,12,0,12,0,0
신촌,43753,22,172,22,172,0,6
신촌,43800,72,42,72,42,0,3
신촌마을입구,90201,36,4,36,4,0,1
신촌마을입구,90202,1,7,1,7,0,0
신촌역2호선,22052,3855,42,3854,42,1,129
신촌오거리.2호선신촌역,22014,6380,83,6375,83,5,215
신촌오거리.2호선신촌역,23035,62,3013,57,3013,5,102
신촌오거리.현대백화점,22013,12042,116,12003,116,39,405
신촌오거리.현대백화점,23034,210,14974,206,14974,4,506
신촌초등학교,40098,221,733,213,733,8,31
신태양아파트,37406,5932,7604,5885,7604,47,451
신태양아파트,37408,8952,4006,8892,4006,60,431
신트리공원,40472,2311,2490,2218,2490,93,160
신트리공원,40496,2635,4331,2591,4331,44,232
신트리공원,40501,2444,1657,2383,1657,61,136
신포동행정복지센터,35153,4016,2241,3963,2241,53,208
신포동행정복지센터,35154,2125,3519,2066,3519,59,188
신포사거리,35791,36,197,35,197,1,7
신포시장,35160,32779,52804,32014,52804,765,2852
신포시장,35254,57100,33576,55784,33576,1316,3022
신포역·인천세관역사공원,35792,220,104,215,104,5,10
신포역·인천세관역사공원,35796,19,16,18,16,1,1
신포역·인천여자상업고등학교,35149,1569,7182,1488,7182,81,291
신포역·인천여자상업고등학교,35150,7075,2814,7025,2814,50,329
신포입구,43491,56,38,48,38,8,3
신포입구,43842,31,29,26,29,5,2
신한빌딩,39901,10705,9279,10557,9279,148,666
신한에이엠,89147,417,16,405,16,12,14
신한일전기,39034,2140,1188,2111,1188,29,110
신현119안전센터,42596,10404,13404,10195,13404,209,793
신현119안전센터,42600,8087,10035,7911,10035,176,604
신현노인회관,43279,41,6,36,6,5,1
신현노인회관,43527,8,44,8,44,0,1
신현리입구,90062,27,76,26,76,1,3
신현북초등학교,42208,4820,343,4761,343,59,172
신현북초등학교,42209,401,3628,393,3628,8,134
신현북초등학교,42210,1377,331,1351,331,26,56
신현북초등학교,42211,83,1504,76,1504,7,52
신현쇼핑,42217,33735,27058,32766,27058,969,2026
신현쇼핑,42220,44711,23938,43988,23938,723,2288
신현여자중학교후문,42214,3253,4048,3124,4048,129,243
신현여자중학교후문,42680,3388,1819,3322,1819,66,173
신현중학교,42205,138,3349,118,3349,20,116
신현초등학교,42178,1713,1868,1662,1868,51,119
신현초등학교,42179,2110,3115,2031,3115,79,174
신화빌라,42626,605,447,603,447,2,35
신화슈퍼,89314,180,3,175,3,5,6
신화슈퍼,89326,1,259,1,259,0,8
신흥교통,35501,306,8,247,8,59,10
신흥교통입구,35841,1315,14,1264,14,51,44
신흥동주민자치센터,35789,123,55,118,55,5,5
신흥동주민자치센터,35799,46,17,42,17,4,2
신흥시장,35145,12130,14912,11828,14912,302,901
신흥시장,35146,17232,9050,16584,9050,648,876
신흥시장,57002,3093,1241,3008,1241,85,144
신흥시장,57004,1717,2718,1665,2718,52,147
신흥시장후문,35812,69,35,65,35,4,3
신흥시장후문,35813,66,72,63,72,3,4
신흥주민지원센터,57013,3771,1911,3735,1911,36,189
신흥주민지원센터,57014,1832,3502,1817,3502,15,177
신흥초등학교,35156,8293,10442,8033,10442,260,624
실내게이트볼장(신현중학교),42204,5227,156,5107,156,120,179
실미도조개구이,35299,9,28,9,28,0,1
실미삼거리,35740,500,101,493,101,7,20
실미삼거리,35741,107,361,107,361,0,15
심곡극동아파트,42272,2113,370,2056,370,57,82
심곡극동아파트,42273,245,1294,236,1294,9,51
심곡도서관,42946,1539,1159,1490,1159,49,89
심곡도서관,89223,452,2114,449,2114,3,85
심곡동광명아파트,89153,6425,2570,6253,2570,172,299
심곡동광명아파트,89154,2487,4042,2443,4042,44,217
심곡천(심곡3교),89381,85,0,85,0,0,2
심곡천(심곡3교),89382,4,199,0,199,4,6
심곡천봉수교,42875,692,529,675,529,17,40
심곡천봉수교,42951,1629,5174,1586,5174,43,226
심곡초등학교(국제성모병원),42288,4036,5512,3949,5512,87,318
심곡초등학교(국제성모병원),42290,5749,3939,5666,3939,83,322
심팩이엔지,89387,1,311,1,311,0,10
십리포제2주차장,44110,76,83,68,83,8,5
십리포해수욕장,44088,95,124,93,124,2,7
십정1동행정복지센터,40049,11462,10458,11307,10458,155,730
십정2동행정복지센터,40056,5444,6792,5379,6792,65,407
십정동차고지,40913,2572,171,2485,171,87,91
십정사거리,40029,6595,5403,6494,5403,101,399
십정사거리,40033,3254,3482,3215,3482,39,224
십정시장입구,40007,17,3742,17,3742,0,125
십정시장입구,40008,3626,20,3586,20,40,121
십정초등학교(동암의원),40041,965,807,936,807,29,59
십정초등학교(동암의원),40042,371,1983,365,1983,6,78
십정초등학교·더샵부평정문,40045,13243,11508,13013,11508,230,825
십정초등학교·더샵부평정문,40048,14157,14696,14002,14696,155,961
쌍마아파트,42112,6314,3190,6093,3190,221,316
쌍마아파트,42114,607,2484,586,2484,21,103
쌍용아파트,37179,5349,2391,5247,2391,102,258
쌍용아파트,37186,1694,3873,1593,3873,101,185
쌍용아파트,37210,644,348,633,348,11,33
쌍용아파트,37228,21380,11950,20997,11950,383,1111
쌍용아파트,37476,13917,22257,13677,22257,240,1205
쌍용아파트,38178,589,782,579,782,10,45
쌍용아파트,38184,768,247,738,247,30,33
쌍용아파트,38469,4586,2684,4478,2684,108,242
쌍용아파트,41434,1294,4410,1273,4410,21,190
쌍용아파트정문,40439,2252,3549,2228,3549,24,193
쌍용자동차인천정비사업소,36144,95,984,93,984,2,35
쑥골고가교,37371,2992,3570,2909,3570,83,218
쑥골고가교,37372,5911,7940,5655,7940,256,461
쑥밭다리,43650,19,7,17,7,2,0
쑥밭다리,43683,11,10,10,10,1,0
아나지고개,41001,2463,3139,2363,3139,100,186
아나지고개,41002,3911,5807,3876,5807,35,323
아동보호센터,35680,114,265,111,265,3,12
아동보호센터,35698,52,29,52,29,0,2
아라노을공원·한신더휴,89404,8902,4982,8865,4982,37,462
아라노을공원·한신더휴,89405,6554,8628,6332,8628,222,506
아라동행정복지센터,42465,6029,12344,5974,12344,55,612
아라동행정복지센터,42467,9780,4830,9714,4830,66,487
아라동행정복지센터(서부고용센터),89401,2269,374,2265,374,4,88
아라동행정복지센터(서부고용센터),89402,395,2470,395,2470,0,95
아라뱃길물류센터,89145,6,173,3,173,3,5
아라센트럴파크,89406,1087,2827,1080,2827,7,130
아라센트럴파크,89407,2780,2148,2748,2148,32,164
아름어린이공원,40337,312,301,307,301,5,20
아름어린이공원,40339,477,403,464,403,13,29
아리마을쉼터,37551,8,1070,8,1070,0,35
아리마을쉼터,37552,1334,246,1288,246,46,52
아모텍,39139,1458,1946,1458,1946,0,113
아시아드경기장(공촌사거리)역,42319,2503,4251,2454,4251,49,225
아시아드경기장(공촌사거리)역,42320,484,1601,432,1601,52,69
아시아드대광로제비앙아파트,89257,753,3484,742,3484,11,141
아시아드대광로제비앙아파트,89258,4152,1396,4069,1396,83,184
아암3교사거리,38727,47,152,47,152,0,6
아암3교사거리,38728,158,137,144,137,14,9
아암물류단지,35285,77,3,64,3,13,2
아암물류단지,35590,13,144,0,144,13,5
아울렛(CGV부평),40818,3505,2410,3429,2410,76,197
아이즈빌(부평CGV),40595,12912,8200,12703,8200,209,703
아이즈빌(부평CGV),40598,10092,12032,9930,12032,162,737
아인스월드,55086,736,1523,716,1523,20,75
아주아파트,38047,1753,585,1712,585,41,77
아주아파트,38051,747,1433,718,1433,29,72
아주아파트,38301,1371,1039,1359,1039,12,80
아주아파트,38304,2328,1411,2315,1411,13,124
아주아파트.미추홀학교,39481,42293,17350,41648,17350,645,1988
아주아파트.미추홀학교,39482,20920,25125,20825,25125,95,1534
아주아파트410동,41575,675,2,675,2,0,22
아침가리마을회관,43287,93,0,80,0,13,3
아침가리마을회관,43867,0,61,0,61,0,2
아쿠아글로리,42811,98,1,90,1,8,3
아현역,22062,4110,23,4104,23,6,137
아현역,23078,17,2268,13,2268,4,76
안골마을입구,38225,9274,9751,9041,9751,233,634
안남고(동보1차아파트),41048,1157,1089,1136,1089,21,74
안남고등학교,41045,3826,981,3789,981,37,160
안동포교회,42700,580,76,494,76,86,21
안동포교회,42701,37,524,35,524,2,18
안동포사거리,42707,50,154,42,154,8,6
안동포사거리입구,42765,441,57,437,57,4,16
안동포사거리입구,42766,115,865,5,865,110,32
안산마을,43132,52,0,41,0,11,1
안산마을,43138,0,68,0,68,0,2
안산초등학교(구계산고교),41425,15733,13021,15629,13021,104,958
안양대학교,43177,612,390,607,390,5,33
안양대학교,43301,696,320,669,320,27,33
안풍산업삼거리,89312,69,1,63,1,6,2
안풍산업삼거리,89329,0,36,0,36,0,1
알앤디써비스,38477,113,1440,112,1440,1,51
알앤디써비스,38478,992,139,984,139,8,37
애관극장,35804,17,64,17,64,0,2
애보박물관,39667,3,21,3,21,0,0
애보박물관,39671,25,22,24,22,1,1
애전마을,43682,9,3,9,3,0,0
애전마을,43894,7,5,7,5,0,0
애전부락,90075,24,92,16,92,8,3
애전부락,90076,84,86,80,86,4,5
앰코코리아(블루오션골프클럽),39880,561,15,559,15,2,19
야곡,43236,54,4,51,4,3,1
야곡,43292,7,40,7,40,0,1
야촌,43210,3,6,2,6,1,0
야촌,43333,0,4,0,4,0,0
약대사거리,57006,4264,890,4263,890,1,171
약대사거리,57010,868,4653,864,4653,4,184
약대주민지원센터.약대초등학교,55080,959,1879,932,1879,27,94
약대주민지원센터.약대초등학교,55088,1967,525,1921,525,46,83
약암호텔,80071,434,75,417,75,17,16
약암호텔,80072,34,377,28,377,6,13
얀센백신,38519,177,1,175,1,2,5
얀센백신,38520,12,472,0,472,12,16
양갑리마을회관,90283,4,53,3,53,1,1
양갑리마을회관,90307,34,0,34,0,0,1
양갑리입구,90282,1,12,1,12,0,0
양갑리입구,90308,29,3,29,3,0,1
양곡도매시장,31037,1960,491,1958,491,2,81
양곡버스정류장,80115,180,541,179,541,1,24
양곡사거리.양촌터미널,80116,387,122,380,122,7,16
양골,43987,4,0,4,0,0,0
양골,43989,0,18,0,18,0,0
양구(오상1리),43262,22,74,22,74,0,3
양구(오상1리),43563,97,20,91,20,6,3
양달마을,43910,54,35,52,35,2,2
양달마을,43911,1,1,1,1,0,0
양도,43074,0,12,0,12,0,0
양도,43075,33,28,27,28,6,2
양도면사무소(나무),43912,432,417,425,417,7,28
양도면사무소(쉘터),43913,701,421,657,421,44,37
양도사거리.대림아파트.신안아파트,80076,647,15,640,15,7,22
양도사거리.삼용아파트,80077,73,509,69,509,4,19
양도초등학교,43329,243,210,238,210,5,15
양도초등학교,43568,187,209,183,209,4,13
양로원,40111,518,2418,517,2418,1,97
양로원,40113,2256,509,2241,509,15,92
양사면사무소,43501,13,64,13,64,0,2
양사면사무소,43658,64,60,63,60,1,4
양사우체국,43465,53,35,48,35,5,2
양사우체국,43736,28,46,28,46,0,2
양사초등학교,43466,111,15,106,15,5,4
양사초등학교,43734,19,57,14,57,5,2
양사파출소,43722,9,14,9,14,0,0
양수장,43592,184,3,179,3,5,6
양수장,43781,1,141,1,141,0,4
양오1리마을회관,43454,0,37,0,37,0,1
양오1리마을회관,43666,46,1,34,1,12,1
양오2리경로당,43453,2,74,2,74,0,2
양오2리경로당,43625,13,0,13,0,0,0
양오2리앞,90049,0,14,0,14,0,0
양오리저수지마을,90102,1,12,1,12,0,0
양오리저수지마을,90103,119,0,113,0,6,3
양오저수지입구,90100,0,8,0,8,0,0
양오저수지입구,90101,8,0,7,0,1,0
양왕마을,43927,14,1,12,1,2,0
양왕마을,43928,4,26,4,26,0,1
양재역,31073,15354,4826,15329,4826,25,672
양재역.서초문화예술회관,31008,2691,2684,2687,2684,4,179
양재역.서초문화예술회관,31010,1731,2084,1731,2084,0,127
양재역말죽거리.강남베드로병원,23318,337,190,337,190,0,17
양지공원,38133,5357,4474,5219,4474,138,327
양지촌,43163,16,2,16,2,0,0
양지촌,43342,9,19,9,19,0,0
양진말입구,90056,1,0,1,0,0,0
양진말입구,90057,1,69,1,69,0,2
양촌중학교,41629,654,978,643,978,11,54
양촌중학교,41630,346,477,343,477,3,27
양평해장국,44145,40,21,25,21,15,2
양평해장국,44178,6,14,5,14,1,0
어두,43206,1,7,1,7,0,0
어두,43280,11,0,11,0,0,0
어두마을,43155,119,9,116,9,3,4
어두마을,43322,12,82,11,82,1,3
어류정입구,90175,60,102,59,102,1,5
어류정입구,90176,16,21,16,21,0,1
어류정입구,90312,1,2,1,2,0,0
어류정항,90323,12,0,10,0,2,0
어류정항,90400,2,2,1,2,1,0
어린이집앞,43402,144,0,135,0,9,4
어린이집앞,43585,4,149,4,149,0,5
에덴하우스,42788,537,2006,527,2006,10,84
에몬스가구,39023,2072,3297,2046,3297,26,178
에몬스가구,39024,3725,1531,3697,1531,28,175
에스틸,89232,266,114,264,114,2,12
에이에프티,39110,950,2254,927,2254,23,106
에코메트로10단지,39728,515,244,511,244,4,25
에코메트로10단지,39736,140,383,137,383,3,17
에코메트로11단지,39652,2097,2379,2047,2379,50,149
에코메트로11단지후문,39701,681,1530,673,1530,8,73
에코메트로12단지,39651,3608,1668,3535,1668,73,175
에코메트로12단지,39653,36,707,33,707,3,24
에코메트로5단지·논현센트럴뷰,39779,684,1483,665,1483,19,72
에코메트로6단지,39716,3818,291,3716,291,102,136
에코메트로6단지,39758,42,2369,38,2369,4,80
에코메트로7단지,39714,9630,4725,9466,4725,164,478
에코메트로7단지,39715,4872,5718,4726,5718,146,353
에코메트로9단지,39750,7679,1069,7349,1069,330,291
에코메트로9단지,39752,1974,4295,1943,4295,31,208
에코메트로더타워,39711,93,635,82,635,11,24
에코크레이션,89449,8,0,8,0,0,0
에코크레이션,89450,0,21,0,21,0,0
엑스포빌리지10단지,38460,2970,1317,2862,1317,108,142
엑스포빌리지9단지,38482,3253,7544,3073,7544,180,359
엑슬루타워,37187,3016,8681,2941,8681,75,389
엑슬루타워,42836,3463,13353,3273,13353,190,560
엘리지안타운,42394,1945,1751,1852,1751,93,123
엘아이지식산업센터,39944,337,1083,329,1083,8,47
엘아이지식산업센터(맞은편),92029,774,193,766,193,8,32
엘지슈퍼,39457,1410,1923,1396,1923,14,111
엠파크타워,42025,3784,4542,3744,4542,40,277
엠파크타워,42026,4925,3780,4880,3780,45,290
여고입구,90232,437,401,417,401,20,27
여고입구,90233,691,651,671,651,20,44
여성의광장,38084,3218,3958,3171,3958,47,239
여성의광장,38085,4560,4153,4438,4153,122,290
여우고개,43980,22,123,19,123,3,4
여우고개,43981,46,37,44,37,2,2
여우별펜션,44142,5,10,5,10,0,0
여우별펜션,44179,3,3,2,3,1,0
여우재,35147,411,319,405,319,6,24
여차리,43424,42,46,41,46,1,2
여차리,43472,44,40,43,40,1,2
여차리회관,43505,38,18,34,18,4,1
여차리회관,43525,21,8,19,8,2,0
역삼역.포스코타워역삼,23288,1265,1187,1265,1187,0,81
연락골,39662,1,59,1,59,0,2
연락골,39665,60,17,60,17,0,2
연리입구,43267,37,0,36,0,1,1
연리입구,43614,39,39,35,39,4,2
연미고개,43198,1,98,1,98,0,3
연미고개,43711,66,1,57,1,9,2
연미정,43193,162,0,141,0,21,5
연미정,43621,0,87,0,87,0,2
연성교회,37278,5827,4985,5665,4985,162,360
연세농장,39851,124,5,119,5,5,4
연세대,39725,1854,7164,1831,7164,23,300
연세대,39861,6497,1127,6483,1127,14,254
연세대송도캠퍼스입구,38489,10483,4826,10389,4826,94,510
연세대학교앞,22058,1827,17,1821,17,6,61
연수1동행정복지센터,38248,217,418,211,418,6,21
연수1동행정복지센터,38251,1222,1242,1172,1242,50,82
연수1차아파트,38187,5000,2584,4867,2584,133,252
연수2차아파트,38195,1297,2157,1259,2157,38,115
연수3동행정복지센터,38262,1268,708,1230,708,38,65
연수경찰서,38111,3159,2428,3108,2428,51,186
연수고등학교,38104,638,2699,613,2699,25,111
연수구청,38089,9362,5250,9013,5250,349,487
연수구청,38093,3881,10464,3795,10464,86,478
연수구청입구,38095,4908,4520,4880,4520,28,314
연수꿈담도서관,38103,8004,5163,7835,5163,169,438
연수병원,38296,4915,2613,4809,2613,106,250
연수여자고등학교,38092,2696,4070,2590,4070,106,225
연수역,38506,2050,2437,2003,2437,47,149
연수역,38507,1175,1790,1167,1790,8,98
연수역북측입구,38572,1612,3053,1565,3053,47,155
연수역북측입구,38573,2347,2733,2317,2733,30,169
연수우체국,38280,7415,3692,7242,3692,173,370
연수우체국,38314,1615,1003,1544,1003,71,87
연수주공3차아파트,38188,3417,4333,3338,4333,79,258
연수중학교,38194,2509,1607,2427,1607,82,137
연수중학교,38196,1064,1295,1041,1295,23,78
연수초등학교,38290,11760,9829,11446,9829,314,719
연수초등학교,38293,4228,4105,4042,4105,186,277
연수한양1차아파트,38091,2460,4468,2428,4468,32,230
연안동행정복지센터,35063,156,9740,145,9740,11,329
연안부두(신선초등학교),35097,1393,3074,1247,3074,146,148
연안부두로삼거리,35754,3,1048,3,1048,0,35
연안부두바다쉼터,35049,1520,23,1491,23,29,51
연안부두어시장,35071,71,7364,63,7364,8,247
연안부두어시장,35072,8119,232,7927,232,192,278
연안아파트,35075,11014,2316,10646,2316,368,444
연안아파트,35076,2131,9485,2017,9485,114,387
연안여객터미널,35057,10620,111,10335,111,285,357
연안여객터미널,35061,58,6803,55,6803,3,228
연안여객터미널,90115,71,60,69,60,2,4
연안여객터미널,90116,57,129,52,129,5,6
연안여객터미널입구,35068,3156,59,2981,59,175,107
연안초등학교,35064,18915,299,18141,299,774,640
연안초등학교,35067,159,13105,150,13105,9,442
연지-기점,90256,2497,2414,2488,2414,9,163
연학초등학교,37137,7230,1940,7146,1940,84,305
연학초등학교,37138,1731,6493,1687,6493,44,274
연합의원,42186,4536,2082,4434,2082,102,220
연화중학교,38117,2642,3326,2601,3326,41,198
연흥아파트,37567,3306,4875,3221,4875,85,272
연흥아파트,37568,2745,5933,2667,5933,78,289
연희공원,42950,114,179,114,179,0,9
연희동광명아파트(사계절썰매장),42314,1728,1961,1703,1961,25,122
연희동광명아파트(사계절썰매장),42599,1712,2197,1685,2197,27,130
연희동행정복지센터,42311,969,1595,959,1595,10,85
연희동행정복지센터,42312,1894,1214,1853,1214,41,103
열우물보조경기장주차장,40916,201,76,135,76,66,9
열우물사거리,40052,6,253,6,253,0,8
열우물전통시장,40028,395,2563,385,2563,10,98
열우물전통시장,40030,2233,382,2191,382,42,87
열우물전통시장입구,40036,2180,345,2138,345,42,84
열우물전통시장입구,40038,227,3306,222,3306,5,117
열우물테니스경기장,40053,4032,3692,3996,3692,36,257
열우물테니스경기장,40054,1010,1139,995,1139,15,71
열우물테니스경기장,40063,371,1105,359,1105,12,49
열우물테니스경기장,40064,211,721,203,721,8,31
열우물테니스경기장,42023,5028,4830,4985,4830,43,328
열우물테니스경기장,42024,2908,2940,2851,2940,57,194
영골,43954,5,2,5,2,0,0
영골,43955,3,20,3,20,0,0
영남1단지.고합아파트,70164,215,242,210,242,5,15
영남아파트,37060,5064,3931,4989,3931,75,299
영남아파트,37063,5344,5044,5175,5044,169,346
영남아파트,38203,2626,1381,2607,1381,19,133
영남아파트,38205,779,2795,772,2795,7,119
영림몰딩도어,39943,51,133,46,133,5,6
영림산업,39028,958,3662,949,3662,9,154
영림임업,39026,1142,3317,1142,3317,0,148
영사목장 앞,90390,0,12,0,12,0,0
영사목장 앞,90391,15,8,11,8,4,0
영선고등학교,40853,12,919,2,919,10,31
영은교회,43037,36,28,35,28,1,2
영은교회,43139,20,105,20,105,0,4
영은슈퍼,89052,221,698,209,698,12,30
영은슈퍼,89064,843,3,787,3,56,28
영음교회.효성해링턴플레이스,41422,1717,2235,1686,2235,31,131
영종KCC스위첸.한양수자인,35449,427,1743,379,1743,48,72
영종KCC스위첸옆문,35755,557,7535,541,7535,16,269
영종KCC스위첸옆문,35756,7913,484,7801,484,112,279
영종LH2단지,35483,912,782,902,782,10,56
영종LH67단지,35872,648,681,630,681,18,44
영종LH67단지,35873,1217,639,1195,639,22,61
영종LH아파트입구,35390,77,62,72,62,5,4
영종e편한세상센텀베뉴·센트럴푸르지오자이,35660,4269,4084,4171,4084,98,278
영종고등학교,35493,2436,2353,2312,2353,124,159
영종고등학교,35496,2140,2248,2003,2248,137,146
영종공원묘지입구,35626,6,31,6,31,0,1
영종공원묘지입구,35627,4,4,4,4,0,0
영종교회,35306,221,282,201,282,20,16
영종교회,35545,932,730,903,730,29,55
영종대교휴게소,42942,3,120,3,120,0,4
영종대교휴게소,42943,92,8,91,8,1,3
영종동행정복지센터,35672,122,191,116,191,6,10
영종동행정복지센터,35673,40,43,40,43,0,2
영종물류고등학교·영종자이아파트,35314,4536,4528,4342,4528,194,302
영종물류고등학교앞·영종자이아파트,35307,6571,3766,6232,3766,339,344
영종버스공영차고지,35837,152,26,63,26,89,5
영종버스공영차고지,35838,119,38,9,38,110,5
영종블루오션,35819,203,134,195,134,8,11
영종블루오션,35820,45,393,45,393,0,14
영종블루오션2차,35876,56,174,52,174,4,7
영종블루오션2차,35877,44,265,42,265,2,10
영종선착장입구,35833,1823,1704,1777,1704,46,117
영종선착장입구,35834,22,231,21,231,1,8
영종성당.정도사,35850,2,38,2,38,0,1
영종성당.정도사,35851,7,9,7,9,0,0
영종센트럴푸르지오자이·e편한세상센텀베뉴,35661,4678,2799,4637,2799,41,249
영종소방서,35765,2,11,2,11,0,0
영종아레나,35830,165,14,139,14,26,5
영종아레나,35831,26,113,2,113,24,4
영종역,35566,34927,697,34503,697,424,1187
영종역,35567,14873,11293,14720,11293,153,872
영종역(2번출구),35870,26,1814,26,1814,0,61
영종역(청라행),35620,83,11170,83,11170,0,375
영종역사관,35624,192,103,176,103,16,9
영종역사관,35625,93,281,93,281,0,12
영종유승한내들스카이스테이,35759,3265,1921,3188,1921,77,172
영종유승한내들스카이스테이,35760,1368,1867,1351,1867,17,107
영종자이아파트,35835,47,136,47,136,0,6
영종자이아파트,35836,416,98,415,98,1,17
영종장로교회,35580,46,62,45,62,1,3
영종장로교회,35581,38,26,34,26,4,2
영종주공7단지,35111,1666,1077,1543,1077,123,91
영종주야간보호센터,35854,1,3,1,3,0,0
영종주야간보호센터,35855,5,2,5,2,0,0
영종중학교,35463,2369,2868,2126,2868,243,174
영종중학교,35464,5481,1628,5157,1628,324,236
영종진공원,35276,880,271,853,271,27,38
영종진공원,35279,96,1478,89,1478,7,52
영종풍림아이원1차,35110,8,213,4,213,4,7
영종하늘도서관,35585,1022,992,985,992,37,67
영종하늘도서관,35586,920,1302,889,1302,31,74
영진아파트,40551,194,536,188,536,6,24
영창한의원,40452,7053,5150,6916,5150,137,406
영풍아파트,36040,9843,3161,9618,3161,225,433
영풍아파트,39546,40,373,40,373,0,13
영흥대교입구,44100,0,4,0,4,0,0
영흥대교입구,44180,3,2,3,2,0,0
영흥면사무소,44131,3,4,0,4,3,0
영흥면사무소,44181,27,7,27,7,0,1
영흥버스터미널,44004,5240,4369,4971,4369,269,320
영흥버스터미널,44116,177,22,162,22,15,6
영흥빌라,44182,2,0,2,0,0,0
영흥수협공판장입구,44009,455,14,448,14,7,15
영흥수협공판장입구,44010,3,672,3,672,0,22
영흥어린이집,44137,10,40,6,40,4,1
영흥우체국,44107,9,33,8,33,1,1
영흥우체국,44183,34,13,33,13,1,1
영흥종합운동장앞,44120,0,34,0,34,0,1
영흥종합운동장앞,44192,20,1,19,1,1,0
영흥초교입구,44101,26,9,24,9,2,1
영흥초교입구,44184,3,9,2,9,1,0
영흥칼국수,44136,2,7,2,7,0,0
영흥플로레도커피,44144,11,14,11,14,0,0
영흥플로레도커피,44185,5,14,5,14,0,0
예단포,35319,117,341,112,341,5,15
예단포,35395,363,86,351,86,12,14
예단포물양장,35622,453,202,451,202,2,21
예단포물양장,35623,41,183,38,183,3,7
예드림빌라입구,35546,52,22,52,22,0,2
예드림빌라입구,35547,29,83,27,83,2,3
예림임업,39053,43,268,43,268,0,10
예림임업,39054,189,148,187,148,2,11
예비군교육장,41272,964,1398,953,1398,11,78
예비군교육장,41273,1642,2587,1629,2587,13,140
예비군교육장입구,90010,38,3,38,3,0,1
예비군교육장입구,90011,2,38,2,38,0,1
예비군훈련장,43201,223,12,222,12,1,7
예비군훈련장,43315,15,181,15,181,0,6
예송중학교,38592,1520,1423,1492,1423,28,98
예송중학교,38593,2351,1407,2156,1407,195,125
예술회관사거리,37254,4160,7934,4093,7934,67,403
예술회관역,39206,4169,10560,4131,10560,38,490
예술회관역(4번출구),39207,5391,5863,5313,5863,78,375
예원앞,41499,50,116,49,116,1,5
예원앞,41515,60,1,60,1,0,2
옐림교회,40854,5375,5133,5346,5133,29,350
옐림교회앞,35684,65,11,65,11,0,2
옐림교회앞,35694,13,53,12,53,1,2
오공본드,39108,4000,3386,3941,3386,59,246
오관물입구,35859,1,0,1,0,0,0
오관물입구,35860,15,1,15,1,0,0
오두돈대,43361,64,12,63,12,1,2
오두돈대,43536,10,41,10,41,0,1
오두리(넙성입구),43638,17,9,16,9,1,0
오두리(넙성입구),43675,6,83,6,83,0,2
오두리종점,43137,81,5,75,5,6,2
오두리종점,43529,0,76,0,76,0,2
오두마을입구,43557,39,0,38,0,1,1
오두마을입구,43647,0,28,0,28,0,0
오라니마을,80360,79,87,79,87,0,5
오류골,43013,261,136,259,136,2,13
오류골,43014,132,267,129,267,3,13
오류내,43389,25,371,25,371,0,13
오류내,43757,497,41,467,41,30,17
오류동마을,41353,1599,671,1566,671,33,75
오류동마을,41354,996,3661,969,3661,27,155
오류동역입구,89058,0,15,0,15,0,0
오류동역입구,89066,30,176,25,176,5,6
오리정,80125,782,156,766,156,16,31
오리정,80126,125,688,118,688,7,27
오상리고인들,43265,20,5,20,5,0,0
오상리고인들,43379,0,23,0,23,0,0
오상입구,43119,19,15,19,15,0,1
오상입구,43120,1,47,1,47,0,1
오상입구,43390,1,83,1,83,0,2
오상입구,43565,101,4,87,4,14,3
오성교회,43555,27,2,26,2,1,0
오성교회,43853,2,34,2,34,0,1
오성아파트,40480,5697,2085,5502,2085,195,259
오성아파트,40487,1689,4563,1630,4563,59,208
오성아파트,40493,401,2016,388,2016,13,80
오성아파트,40721,195,347,188,347,7,18
오성정밀,39490,615,993,608,993,7,53
오이도역,70031,798,6618,786,6618,12,247
오이도역,70032,5975,817,5889,817,86,226
오정휴먼시아(중),57044,258,2050,254,2050,4,76
오정휴먼시아(중),57045,2044,326,2030,326,14,79
오조산공원,41246,1972,1230,1933,1230,39,106
오조산공원,41249,3032,3236,2832,3236,200,208
오조산공원,41621,49,411,17,411,32,15
옥골.옥토끼우주센터,43033,171,182,169,182,2,11
옥골.옥토끼우주센터,43561,108,68,105,68,3,5
옥골사거리,38731,472,3452,432,3452,40,130
옥골사거리,38732,469,193,430,193,39,22
옥금말,43952,110,24,67,24,43,4
옥금말,43953,23,53,22,53,1,2
옥련1동행정복지센터,38217,8847,5821,8754,5821,93,488
옥련2동행정복지센터(옥련우체국),38450,2769,53,2707,53,62,94
옥련2동행정복지센터(옥련우체국),38451,1135,2520,1118,2520,17,121
옥련고개,38212,1686,3423,1644,3423,42,170
옥련고개,38219,1570,1154,1505,1154,65,90
옥련동성당,38330,861,2019,846,2019,15,96
옥련사거리,38170,862,1159,838,1159,24,67
옥련사거리,38171,1667,823,1588,823,79,83
옥련여고입구,38271,799,746,758,746,41,51
옥련여고입구,38273,886,2352,850,2352,36,107
옥련중학교,38470,7265,4503,6954,4503,311,392
옥련지구대,38223,1242,4002,1151,4002,91,174
옥련초등학교,38146,4026,4189,3905,4189,121,273
옥림교회,43202,39,2,32,2,7,1
옥림교회,43716,0,65,0,65,0,2
옥림슈퍼,43205,209,4,197,4,12,7
옥림슈퍼,43720,37,123,37,123,0,5
온누리병원,42425,263,908,243,908,20,39
온수교차로,90231,6,120,6,120,0,4
온수리,43018,6046,1987,5792,1987,254,267
온수리,43020,3395,5156,3162,5156,233,285
온수시장,43019,60,23,56,23,4,2
온수시장,43095,30,391,28,391,2,14
올리브백화점,39359,4120,1635,4070,1635,50,191
올리브백화점,39363,1931,2565,1900,2565,31,149
올리브백화점,39364,14672,14036,14384,14036,288,956
올리브백화점,39589,16809,17985,16547,17985,262,1159
올리브백화점,39746,16361,18541,16183,18541,178,1163
올리브백화점,39747,23293,26854,23086,26854,207,1671
올림픽공원,39209,2987,4566,2965,4566,22,251
올림픽공원,39210,399,764,391,764,8,38
올림픽생활기념관,39349,4670,5842,4634,5842,36,350
옹장골,43171,5,53,5,53,0,1
옹장골,43230,126,5,118,5,8,4
옹진군청,37019,1226,2279,1217,2279,9,116
옹진군청,37020,8289,1309,8114,1309,175,319
완정공단입구,42409,6206,3940,5993,3940,213,338
완정사거리,42561,21976,8111,21815,8111,161,1002
완정사거리,42562,242,1516,208,1516,34,58
완정역,42673,12940,28775,12750,28775,190,1390
완정역,42674,6864,16272,6745,16272,119,771
완정초등학교.검단도서관,42414,3669,6264,3567,6264,102,331
완정초등학교.검단도서관,42415,4963,5754,4637,5754,326,357
왕궁가든,41289,1870,2326,1835,2326,35,139
왕궁가든,41291,2140,2963,2069,2963,71,170
왕길고가,42551,1052,30,1032,30,20,36
왕길고가,42552,10,1156,9,1156,1,38
왕길동,42386,15,270,15,270,0,9
왕길동,42387,95,121,83,121,12,7
왕길동(기점),42699,998,18,908,18,90,33
왕길동종점,42594,317,404,13,404,304,24
왕길역,89199,354,128,344,128,10,16
왕길역,89200,154,568,137,568,17,24
왕리물,90098,1,6,1,6,0,0
왕산골,35490,80,23,77,23,3,3
왕산골,35491,35,73,35,73,0,3
왕산교,35632,29,56,29,56,0,2
왕산교,35633,0,29,0,29,0,0
왕산차고지,35403,662,147,641,147,21,26
왕산차고지,35720,129,7,127,7,2,4
왕산해수욕장(왕산요트경기장),35020,1383,203,1370,203,13,52
왕산해수욕장(왕산요트경기장),35021,225,1300,207,1300,18,50
외1리마을회관앞,44096,31,31,22,31,9,2
외1리마을회관앞,44186,35,1,35,1,0,1
외1리소장골,44133,54,58,54,58,0,3
외뜰,43687,10,16,9,16,1,0
외뜰,43745,11,20,11,20,0,1
외리보건지소앞,44095,16,21,13,21,3,1
외리보건지소앞,44187,2,0,2,0,0,0
외주,43181,81,20,74,20,7,3
외주,43241,5,100,5,100,0,3
외포1리,43283,7,101,6,101,1,3
외포고개,43244,91,135,85,135,6,7
외포고개,43366,2,108,2,108,0,3
외포리,43556,1459,1523,1389,1523,70,99
외포리(싱싱마트),90376,45,15,38,15,7,2
외포리(하나로마트),90387,1,82,1,82,0,2
외포리(하나로마트),90388,118,29,110,29,8,4
외포리소공원,90127,34,14,31,14,3,1
외포리소공원,90128,1,46,1,46,0,1
외포리정미소,43240,109,8,103,8,6,3
외포삼거리,43110,388,111,366,111,22,16
외포삼거리,43285,0,66,0,66,0,2
요곡,43655,150,141,142,141,8,9
요곡,43762,64,29,57,29,7,3
요골,43590,69,0,69,0,0,2
요골,43780,0,7,0,7,0,0
용갈비,40338,72,2421,64,2421,8,83
용구물길,90385,1,29,1,29,0,1
용구물길,90386,18,0,13,0,5,0
용궁사입구,35578,85,620,84,620,1,23
용궁사입구,35579,591,50,571,50,20,21
용남시장,37232,17541,14775,17118,14775,423,1077
용남시장,37236,17810,18439,17316,18439,494,1208
용남파출소,37177,7135,2153,7060,2153,75,309
용남파출소,37184,3471,9753,3433,9753,38,440
용담공원,38172,1261,1972,1254,1972,7,107
용담공원,38177,1925,1368,1864,1368,61,109
용담마을,38191,5168,5398,5029,5398,139,352
용담마을,38192,4672,3186,4579,3186,93,261
용담바다낚시터,44132,0,1,0,1,0,0
용담바다낚시터,44188,2,0,2,0,0,0
용담어촌계앞,44097,18,14,17,14,1,1
용담어촌계앞,44189,3,0,3,0,0,0
용당사터,43537,22,0,21,0,1,0
용당사터,43677,0,27,0,27,0,0
용유동행정복지센터,35017,108,55,103,55,5,5
용유동행정복지센터,35211,67,169,65,169,2,7
용유동행정복지센터,35411,174,223,166,223,8,13
용유동행정복지센터,35412,153,95,146,95,7,8
용유역,35433,67,200,67,200,0,8
용유초등학교,35022,263,38,255,38,8,10
용유초등학교,35023,45,293,42,293,3,11
용유초등학교,35409,45,402,38,402,7,14
용유초등학교삼거리,35410,361,53,361,53,0,13
용일사거리,37208,28799,21418,28546,21418,253,1673
용일사거리,37218,26577,27366,26188,27366,389,1798
용일사거리,37251,1250,1504,1213,1504,37,91
용일초등학교,37233,11858,8199,11705,8199,153,668
용일초등학교,37237,8048,15585,7792,15585,256,787
용정리 사거리,43721,1,182,1,182,0,6
용정마을회관,43370,0,50,0,50,0,1
용정마을회관,43615,309,0,276,0,33,10
용정초등학교,37297,1270,668,1255,668,15,64
용정초등학교,37299,618,2319,603,2319,15,97
용진주택,43084,226,47,211,47,15,9
용진주택,43085,8,10,8,10,0,0
용진진,43639,1,22,1,22,0,0
용진진,43678,5,1,5,1,0,0
용현2동행정복지센터,37653,1280,162,1272,162,8,48
용현2동행정복지센터,37654,307,1519,217,1519,90,60
용현3동행정복지센터.보훈병원,37221,22032,16609,21578,16609,454,1288
용현3동행정복지센터.보훈병원,37224,12262,12623,11996,12623,266,829
용현5동행정복지센터,37129,247,808,246,808,1,35
용현고가교,37550,101,1926,96,1926,5,67
용현고가교,37611,6383,1617,6360,1617,23,266
용현고개,37178,3718,3585,3594,3585,124,243
용현고개,37497,4028,5157,3982,5157,46,306
용현동농협,37117,491,3281,490,3281,1,125
용현동상우빌라,37564,5,760,4,760,1,25
용현동상우빌라,37565,1548,57,1475,57,73,53
용현동성원상떼빌아파트,37546,489,477,438,477,51,32
용현사거리,37212,1401,1317,1359,1317,42,90
용현사거리,37213,1322,4019,1220,4019,102,178
용현시장,37227,23477,27355,22753,27355,724,1694
용현시장,37230,24931,14516,24387,14516,544,1314
용현시장,37268,5444,3337,5256,3337,188,292
용현시장,37270,4426,5439,4263,5439,163,328
용현아파트,37153,22,370,22,370,0,13
용현중학교,37021,3127,568,3074,568,53,123
용현중학교,37028,1072,2646,1028,2646,44,123
용현초등학교,37508,1,780,1,780,0,26
용현초등학교입구,37128,11465,3562,11238,3562,227,500
용현초등학교입구,37134,6690,12759,6518,12759,172,648
용화사(길상낚시터),90077,16,32,16,32,0,1
용화사(길상낚시터),90080,64,29,64,29,0,3
우뢰촌,43425,199,70,198,70,1,8
우뢰촌,43792,104,66,100,66,4,5
우리자동차,35223,935,219,680,219,255,38
우림라이온스밸리,40592,357,4838,353,4838,4,173
우림라이온스밸리,40594,9210,1342,9146,1342,64,351
우림필유아파트,42924,3052,1642,2994,1642,58,156
우림필유아파트,42925,1413,2623,1365,2623,48,134
우물골,43929,25,10,23,10,2,1
우물골,43930,3,16,3,16,0,0
우미린1단지정문,35583,2935,875,2898,875,37,127
우미린1단지정문,35584,1124,2863,1102,2863,22,132
우미린1단지후문,35461,1261,4431,1221,4431,40,189
우미린1단지후문,35462,4639,824,4598,824,41,182
우미린2단지정문,35512,4075,1499,3996,1499,79,185
우미린2단지정문,35513,2682,4647,2608,4647,74,244
우미린2단지후문,35454,2950,1634,2824,1634,126,152
우미린더시그니처(후문),89443,3482,299,3474,299,8,126
우성1차아파트,38094,4403,4541,4244,4541,159,298
우성1차아파트,39834,266,34,256,34,10,10
우성2차아파트(옥련동),38356,2478,880,2436,880,42,111
우성2차아파트·원인재역(4번출구),38150,2791,6262,2762,6262,29,301
우성4차,40185,7915,236,7797,236,118,271
우성4차,40187,172,6870,169,6870,3,234
우성4차후문,40730,186,2836,184,2836,2,100
우성4차후문,40731,3601,241,3537,241,64,128
우성아파트,38143,4334,2228,4252,2228,82,218
우성아파트,38357,1389,2293,1342,2293,47,122
우성아파트,40341,720,1257,713,1257,7,65
우성아파트,42717,2623,4617,2608,4617,15,241
우성아파트,42718,1653,2184,1622,2184,31,127
우성아파트.은행교회,70026,652,33,618,33,34,22
우저서원(대성주유소),35214,175,88,169,88,6,8
우저서원(대성주유소),35215,60,755,60,755,0,27
우주골드타운빌라,40863,702,1174,692,1174,10,62
우주골드타운빌라,40864,420,1265,420,1265,0,56
우주아파트,38252,8047,9435,7871,9435,176,582
우진기계,89106,47,289,47,289,0,11
우진아파트,37158,1870,2080,1815,2080,55,131
우진아파트,37159,535,2672,509,2672,26,106
우체국사거리,39694,823,1387,799,1387,24,73
우체국사거리,39695,1744,766,1620,766,124,83
우체국사거리,39704,2450,3732,2373,3732,77,206
욱일아파트후문,40877,1444,1947,1434,1947,10,113
운남교차로,35435,39,157,39,157,0,6
운남교차로,35444,117,103,116,103,1,7
운남교차로,35524,48,34,48,34,0,2
운남교차로,35582,10,51,10,51,0,2
운남교차로 입구,35839,10,12,9,12,1,0
운남교차로 입구,35840,34,12,32,12,2,1
운남교차로.잔다리,35595,548,250,533,250,15,26
운남교차로.잔다리,35596,202,569,198,569,4,25
운남동,35268,101,243,96,243,5,11
운남동,35281,227,322,225,322,2,18
운남동우체국,35848,241,139,240,139,1,12
운남동우체국,35849,159,337,146,337,13,16
운남초교사거리,35706,26,153,25,153,1,5
운남초교사거리,35707,445,210,444,210,1,21
운북공영차고지,35779,362,3,352,3,10,12
운북공영차고지,35783,1,311,1,311,0,10
운서SKVIEW 스카이시티,35780,12,1,12,1,0,0
운서SKVIEW·세계로향하는교회,35781,0,6,0,6,0,0
운서역,35242,22068,13746,21755,13746,313,1193
운서역,35257,7774,14820,7607,14820,167,753
운서역(남동측),35775,3,23,2,23,1,0
운서역(남동측),35776,37,26,37,26,0,2
운서역(하워드존슨호텔),35747,2885,4258,2868,4258,17,238
운서역금강펜테리움아파트,35482,587,651,581,651,6,41
운서초등학교,35270,5785,2360,5663,2360,122,271
운서초등학교,35282,2688,3394,2590,3394,98,202
운양역,80348,254,307,253,307,1,18
운양역,80351,260,115,260,115,0,12
운연동,39374,616,647,584,647,32,42
운연동,39379,599,722,587,722,12,44
운연동,39673,55,0,53,0,2,1
운연삼거리,39987,542,1590,519,1590,23,71
운연삼거리,39988,104,595,96,595,8,23
운연역,39954,11009,10919,10945,10919,64,730
운연역,92026,6640,7446,6610,7446,30,469
운연천,92027,274,883,266,883,8,38
운연천,92028,473,177,471,177,2,21
운전면허시험장,39005,2222,628,2202,628,20,95
울레기,43179,12,178,11,178,1,6
울레기,43548,192,17,172,17,20,6
웃말,90169,4,12,4,12,0,0
웃말,90170,33,19,33,19,0,1
원당고등학교,42459,2885,3438,2841,3438,44,210
원당사거리.검단선사박물관,42446,19179,7549,18959,7549,220,890
원당사거리.검단선사박물관,42447,11215,18650,11058,18650,157,995
원당중고등학교,42460,62,250,61,250,1,10
원당중고등학교,42462,163,269,163,269,0,14
원동초등학교,39656,1819,7657,1670,7657,149,315
원동초등학교,39657,10894,2076,10690,2076,204,432
원성골,35434,58,182,58,182,0,8
원성골,35445,86,286,81,286,5,12
원수리마을,90251,2,9,2,9,0,0
원수리마을,90252,8,5,8,5,0,0
원인재역(1번출구),38162,2077,7131,2064,7131,13,306
원인재역(4번출구),38153,9482,2741,9448,2741,34,407
원인재역(6번출구),38166,7441,2539,7395,2539,46,332
원적산터널,40821,1242,3689,1191,3689,51,164
원적산터널,40822,1494,2785,1472,2785,22,142
원적산터널서측,42666,5975,4236,5822,4236,153,340
원적산터널서측,42667,3961,4092,3899,4092,62,268
원종IC(중),57046,32,3121,29,3121,3,105
원종IC(중),57047,972,73,966,73,6,34
원진운수차고지,89003,716,15,684,15,32,24
원진운수차고지,89004,21,655,10,655,11,22
원창동(기점),89143,2675,17,2580,17,95,89
원창동(기점),89144,104,2268,16,2268,88,79
원창동(종점),42183,14,1045,5,1045,9,35
원창동(종점),42184,689,99,628,99,61,26
원흥아파트,38131,24833,15898,24242,15898,591,1357
원흥아파트,38336,33340,21695,32772,21695,568,1834
원흥아파트,42793,82,5,79,5,3,2
월곳삼거리,43188,0,50,0,50,0,1
월곳삼거리,43619,45,0,45,0,0,1
월곶,70002,179,5,92,5,87,6
월곶JC(미정차),70207,2,0,2,0,0,0
월곶동주민센터.월곶포구,70006,891,187,876,187,15,35
월곶동주민센터.월곶포구,70005,220,1380,202,1380,18,53
월곶풍림아파트3차,70030,65,89,50,89,15,5
월드메르디앙아파트,42161,4371,4808,4170,4808,201,305
월드메르디앙아파트,42163,6271,3542,6123,3542,148,327
월드아파트,42499,7720,9519,7625,9519,95,574
월드아파트,42500,11748,6040,11667,6040,81,592
월미공원,35138,77,867,77,867,0,31
월미공원,35572,202,41,194,41,8,8
월미공원역,35345,175,4037,152,4037,23,140
월미공원역,35346,6506,313,6400,313,106,227
월미도,35148,39754,313,38243,313,1511,1335
월미도(시티투어),35144,923,16732,858,16732,65,588
월미도문화관,35558,1924,44,1875,44,49,65
월미도종점,35368,393,8023,250,8023,143,280
월미문화의거리,35132,23,4289,22,4289,1,143
월미문화의거리,35219,2804,25,2703,25,101,94
월미테마파크,35128,118,14161,106,14161,12,475
월미테마파크,35502,7537,63,7288,63,249,253
월선포,90040,91,133,75,133,16,7
월선포,90041,76,7,72,7,4,2
웨딩타운,22061,183,5,183,5,0,6
웨딩타운,23077,0,34,0,34,0,1
웰카운티,38352,1317,6132,1280,6132,37,248
웰카운티,38353,12443,1509,11995,1509,448,465
웰카운티,42772,1643,4066,1549,4066,94,190
웰카운티17단지,89182,3070,799,3023,799,47,128
웰카운티17단지,89183,865,2541,820,2541,45,113
웰카운티1단지,38648,919,2028,895,2028,24,98
웰카운티1차,42746,1926,1150,1920,1150,6,102
웰카운티1차,42764,1662,1391,1631,1391,31,101
웰카운티2단지,38709,583,812,555,812,28,46
웰카운티4단지,38446,782,157,718,157,64,31
웰카운티4단지,38447,146,1261,144,1261,2,46
윗말,43488,8,6,8,6,0,0
윗말,43839,2,3,1,3,1,0
윗망월,43335,0,98,0,98,0,3
윗망월,43578,139,0,136,0,3,4
유니온프라자,42113,11611,7806,11476,7806,135,647
유림골프장,41469,900,7,889,7,11,30
유성아파트,43086,94,672,93,672,1,25
유성아파트,43087,681,52,668,52,13,24
유수지,39010,663,712,649,712,14,45
유수지,39011,523,2103,520,2103,3,87
유수지근린공원,39019,1050,875,1038,875,12,64
유수지근린공원,39020,707,742,707,742,0,48
유수지길,39003,1070,2314,1053,2314,17,112
유수지길,39004,1409,921,1404,921,5,77
유승아파트,42397,2104,386,2069,386,35,83
유승아파트,42398,343,1796,333,1796,10,71
유승아파트(삼성홈타운아파트),41003,4165,3146,4100,3146,65,243
유승아파트(삼성홈타운아파트),41004,3638,3726,3546,3726,92,245
유승아파트(삼성홈타운아파트),41005,6015,2072,5850,2072,165,269
유승아파트(삼성홈타운아파트),41006,1888,6430,1814,6430,74,277
유승아파트(삼성홈타운아파트),41583,6,312,6,312,0,10
유원아파트,37163,6221,9955,5997,9955,224,539
유원아파트,37172,13428,5066,13166,5066,262,616
유진시스템앞,40676,1093,4593,1078,4593,15,189
유진시스템앞,40678,2189,1141,2139,1141,50,111
유천아파트,38254,854,781,827,781,27,54
유천아파트,38266,7422,4798,7325,4798,97,407
유천아파트후문,38265,293,769,289,769,4,35
유현마을.신동아아파트,80001,81,226,81,226,0,10
유현마을.신동아아파트,80073,301,19,301,19,0,10
유현사거리,42484,5743,9300,5701,9300,42,501
유현사거리,42487,8416,4242,8376,4242,40,421
유호엔시티.논현푸르지오,39823,68,1657,62,1657,6,57
육골,18805,6,86,5,86,1,3
육골,62030,6,1,2,1,4,0
윤성아파트,38307,250,1873,242,1873,8,70
윤성아파트(인항고교),37011,5751,4998,5600,4998,151,358
윤성아파트(인항고교),37012,4426,2438,4303,2438,123,228
율도근린공원,89339,307,54,305,54,2,12
율도근린공원,89340,673,1294,664,1294,9,65
율도근린공원입구,89428,228,121,212,121,16,11
율도근린공원입구,89429,197,159,193,159,4,11
율도입구,42188,1338,1181,1307,1181,31,83
율도입구,42190,872,1009,859,1009,13,62
율목동행정복지센터,35787,25,69,23,69,2,3
율목동행정복지센터,35801,176,14,166,14,10,6
율목오거리,35786,34,35,25,35,9,2
율목오거리,35802,75,23,71,23,4,3
율생리입구,80016,198,941,192,941,6,37
율생리입구,80017,1117,209,1034,209,83,44
은계초등학교.사랑스러운교회,70025,1725,33,1672,33,53,58
은골공원,35599,1452,2380,1439,2380,13,127
은골공원,35600,2309,1696,2192,1696,117,133
은골사거리,35309,247,205,213,205,34,15
은당골,90212,20,22,20,22,0,1
은당골,90213,16,28,16,28,0,1
은봉초등학교,39613,12022,3140,11644,3140,378,505
은봉초등학교,39614,3257,13714,3121,13714,136,565
은성아파트,39321,7918,3554,7750,3554,168,382
은성프레미오,39325,1947,5106,1899,5106,48,235
은영빌라,41089,1785,108,1775,108,10,63
은영아파트,42218,4212,3808,4029,3808,183,267
은지초등학교사거리,42365,4830,5203,4718,5203,112,334
은하마을.중흥마을,55069,469,1536,450,1536,19,66
은하목장앞,43274,0,2,0,2,0,0
은하목장앞,43852,1,6,1,6,0,0
은하쌍용아파트,55062,1208,6005,1186,6005,22,240
은행마을,41198,8704,3024,8577,3024,127,390
은행초등학교,70019,2966,89,2890,89,76,101
을왕리해수욕장,35009,7241,696,7150,696,91,264
을왕리해수욕장,35010,791,8705,781,8705,10,316
을왕리해수욕장.더위크앤리조트,35015,3066,527,3039,527,27,119
을왕리해수욕장.더위크앤리조트,35016,544,2678,538,2678,6,107
읍내리마을회관입구,90032,0,61,0,61,0,2
읍내리마을회관입구,90033,119,0,93,0,26,3
응곡,43696,41,27,40,27,1,2
응곡,43749,35,30,34,30,1,2
이강리방앗간,43691,122,2,115,2,7,4
이강리방앗간,43832,7,188,6,188,1,6
이건창생가,43145,59,3,49,3,10,2
이건창생가,43434,3,72,2,72,1,2
이규보묘입구,90065,79,67,66,67,13,4
이규보묘입구,90389,72,60,72,60,0,4
이대역,22015,4965,58,4957,58,8,167
이대역,22057,3204,23,3200,23,4,107
이대역,23036,30,6393,27,6393,3,214
이마트,41122,5798,17926,5637,17926,161,790
이마트,41125,25810,10054,25541,10054,269,1195
이마트송림점,36098,5298,7718,5161,7718,137,433
이마트송림점,36100,8337,5382,8260,5382,77,457
이안송도,38409,21167,6149,20863,6149,304,910
이영화학,39644,2640,1061,2611,1061,29,123
이음5로.금호어울림센트럴,89433,93,858,93,858,0,31
이음5로.우미린더시그니처,89432,384,145,384,145,0,17
이음대로.대성베르힐,89440,624,49,617,49,7,22
이음대로.대성베르힐,89441,110,1497,99,1497,11,53
이음대로.디에트르더펠리체,89438,3460,286,3446,286,14,124
이음대로.호반써밋,89439,415,1416,415,1416,0,61
이촌,43312,0,2,0,2,0,0
이촌,43768,6,1,5,1,1,0
이토상가,39196,7745,2082,7597,2082,148,327
이현(이강리교회),43661,3,126,3,126,0,4
이현(이강리교회),43690,125,1,112,1,13,4
이화1동입구,41487,130,132,128,132,2,8
이화1동입구,41506,17,1,17,1,0,0
이화2동마을회관,41484,16,12,16,12,0,0
이화2동마을회관,41504,75,59,75,59,0,4
이화2동회차지,41486,40,32,40,32,0,2
이화교회앞,41489,53,66,52,66,1,3
이화동노인정,41490,198,100,193,100,5,9
이화동다리,41479,76,167,68,167,8,8
이화동다리,41516,278,11,277,11,1,9
이화진등마을경로당,41601,39,35,38,35,1,2
인고앞,37318,3875,6236,3739,6236,136,337
인고앞,37338,7231,4526,7076,4526,155,391
인고체육관,37305,9448,4690,9258,4690,190,471
인고체육관(동양장사거리),37309,8378,8041,8192,8041,186,547
인내마을,90181,19,25,19,25,0,1
인내마을,90182,12,6,12,6,0,0
인명여자고등학교,37199,32582,6586,32143,6586,439,1305
인명여자고등학교,37205,9625,43518,9416,43518,209,1771
인사리군부대앞,90268,13,21,13,21,0,1
인사리군부대앞,90270,8,1,8,1,0,0
인사리마을회관,90267,2,30,2,30,0,1
인사리마을회관,90271,11,2,11,2,0,0
인사리우무렛골,90266,7,40,7,40,0,1
인사리인현경로당앞,90269,19,13,19,13,0,1
인사리지석교회,90272,13,6,13,6,0,0
인산저수지,43354,65,88,63,88,2,5
인산저수지,43575,47,75,44,75,3,4
인삼농협앞,80305,31,246,26,246,5,9
인삼농협앞,80306,369,25,347,25,22,13
인성여자고등학교,35793,144,760,114,760,30,30
인성여자고등학교,35808,42,563,41,563,1,20
인송빌라,40241,3150,43,3112,43,38,106
인수초등학교,39386,11075,10201,10991,10201,84,709
인수초등학교,39392,14025,12469,13935,12469,90,883
인썸호텔,44134,87,57,82,57,5,4
인아교회,35091,1138,169,1032,169,106,43
인아교회,35094,185,1043,178,1043,7,40
인재개발원,42281,1076,2312,1029,2312,47,112
인재개발원,42282,2406,1306,2331,1306,75,123
인제고등학교,39548,373,1269,359,1269,14,54
인천가정법원.인천지방법원등기국,37405,9567,12520,9382,12520,185,736
인천가정법원.인천지방법원등기국,37409,22237,20536,22004,20536,233,1425
인천가족공원입구,39493,725,547,709,547,16,42
인천가족공원입구,39495,1012,1734,966,1734,46,91
인천가족공원입구,92059,1684,1325,1644,1325,40,100
인천가톨릭대학교,39931,4213,1414,4154,1414,59,187
인천경로당앞,90226,29,27,29,27,0,1
인천경로당앞,90227,8,19,8,19,0,0
인천경연초중학교,89347,44,233,42,233,2,9
인천공항T1(1층13B),35205,7079,123,6977,123,102,240
인천공항T1(1층2A),35344,42573,3604,42040,3604,533,1539
인천공항T1(1층2B),35202,12654,6570,12600,6570,54,640
인천공항T1(3층13번),35556,1287,11181,1183,11181,104,415
인천공항T1(3층14번),35753,928,4373,854,4373,74,176
인천공항T1(3층2번),35032,3416,36935,3393,36935,23,1345
인천공항T1(3층6번),35752,3796,9781,3763,9781,33,452
인천공항T1(3층7번),35203,14838,38700,14741,38700,97,1784
인천공항T1-3층,35325,18,11,18,11,0,0
인천공항T2(1)A(1층),35618,19508,53,19419,53,89,652
인천공항T2(1)번출입구(3층),35614,2752,19944,2738,19944,14,756
인천공항T2(6)B(1층),35619,3237,397,3223,397,14,121
인천공항T2(8)번출입구(3층),35615,224,5472,195,5472,29,189
인천공항T2-3층,35611,10,0,10,0,0,0
인천공항T2-B1층,35612,23,0,23,0,0,0
인천공항전망대,35365,5,40,5,40,0,1
인천공항전망대,35366,35,7,31,7,4,1
인천공항전망대(미정차),35630,21,0,21,0,0,0
인천공항충전소입구,35757,5,12,3,12,2,0
인천공항충전소입구,35758,47,1,47,1,0,1
인천과학예술영재학교,38579,180,41,178,41,2,7
인천과학예술영재학교,38580,31,511,29,511,2,18
인천광역시종합건설본부,37325,7721,6797,7580,6797,141,483
인천교(인천기계산업단지),37449,1998,1091,1964,1091,34,102
인천교(인천기계산업단지),37451,464,1550,451,1550,13,67
인천교삼거리,37453,3208,5218,3074,5218,134,280
인천교삼거리(인천기계산업단지),37452,2707,1961,2652,1961,55,155
인천교통공사,40032,40819,35421,40281,35421,538,2541
인천교회,38676,1607,4947,1559,4947,48,218
인천교회,39260,3593,4025,3521,4025,72,253
인천교회,39261,3931,2648,3851,2648,80,219
인천국민안전체험관,42233,0,76,0,76,0,2
인천국민안전체험관,42234,42,224,26,224,16,8
인천국제공항,35613,38,0,38,0,0,1
인천국제수산물타운,35815,33,1362,32,1362,1,46
인천국제수산물타운,35816,628,67,589,67,39,23
인천글로벌캠퍼스,39850,1989,2596,1948,2596,41,152
인천글로벌캠퍼스,39858,1939,1568,1896,1568,43,116
인천기계공고,37272,20396,7706,20223,7706,173,936
인천기계공고,37281,4474,13910,4455,13910,19,612
인천기계산업단지,37579,947,53,942,53,5,33
인천기계산업단지,37580,19,893,18,893,1,30
인천기독병원,35785,218,315,184,315,34,17
인천기독병원,35803,63,115,40,115,23,5
인천나비공원,40849,4946,47,4837,47,109,166
인천남동우체국,39630,7442,7601,7271,7601,171,501
인천남부초.힐스테이트푸르지오,37275,10016,14670,9745,14670,271,822
인천논현역앞,39658,11509,15629,11347,15629,162,904
인천논현역앞,39659,14900,9241,14694,9241,206,804
인천논현중학교,92060,160,1637,148,1637,12,59
인천논현중학교,92061,313,150,294,150,19,15
인천논현중학교,92062,1125,116,1077,116,48,41
인천대검도수련원,43456,0,102,0,102,0,3
인천대검도수련원,43695,58,0,58,0,0,1
인천대공원,39471,6288,1060,6209,1060,79,244
인천대공원,39478,5280,9549,5189,9549,91,494
인천대공원역,39395,8883,2607,8804,2607,79,383
인천대공원역,39398,82,3319,81,3319,1,113
인천대공원후문(장수동),39442,5859,1040,5721,1040,138,229
인천대입구역,38395,47733,15504,47621,15504,112,2107
인천대입구역,38396,13762,44577,13564,44577,198,1944
인천대입구역.롯데몰,38646,3109,746,3100,746,9,128
인천대입구역.롯데몰,38649,32,1583,32,1583,0,53
인천대정문,38385,20903,621,20828,621,75,717
인천대정문,38386,712,18285,702,18285,10,633
인천대학교공과대학,38376,34,8333,26,8333,8,278
인천대학교공과대학,38377,30186,129,30070,129,116,1010
인천대학교공과대학,38499,1222,18912,992,18912,230,671
인천대학교자연과학대학,38375,87,10617,67,10617,20,356
인천대학교자연과학대학,38378,14108,245,13994,245,114,478
인천마전도서관,42556,14,688,12,688,2,23
인천만수고등학교,39680,2836,2134,2816,2134,20,165
인천만수고등학교,39681,1933,2644,1924,2644,9,152
인천미래생활고등학교,40470,4425,4684,4406,4684,19,303
인천미래생활고등학교,40474,6534,5577,6485,5577,49,403
인천미래생활고등학교,40483,949,2277,937,2277,12,107
인천미래생활고등학교,55032,3296,1315,3229,1315,67,153
인천박문초등학교,38608,253,113,250,113,3,12
인천박문초등학교,38609,107,326,104,326,3,14
인천보건고등학교,42144,3423,4803,3290,4803,133,274
인천보건고등학교,42146,5636,4048,5451,4048,185,322
인천부흥고등학교,40279,1134,491,1124,491,10,54
인천북항관공선부두,89195,14,848,9,848,5,28
인천북항관공선부두,89196,676,10,669,10,7,22
인천북항부두운영시설,42953,4,331,4,331,0,11
인천북항부두운영시설,42959,430,24,426,24,4,15
인천뷰티예술고등학교,38052,3731,3976,3598,3976,133,256
인천뷰티예술고등학교,38053,7703,3984,7572,3984,131,389
인천비즈니스고등학교,37421,4375,4107,4236,4107,139,282
인천비즈니스고등학교,37423,5305,4106,5252,4106,53,313
인천비즈니스고등학교,37614,8151,3923,8083,3923,68,402
인천비지니스고등학교,37615,495,3356,488,3356,7,128
인천상공회의소,92041,84,0,84,0,0,2
인천상륙작전기념관,38671,21,14,19,14,2,1
인천상륙작전기념관,38672,7,28,7,28,0,1
인천서곶초등학교,89355,459,6,445,6,14,15
인천서곶초등학교,89358,14,1053,8,1053,6,35
인천서부교육지원청,42336,460,316,449,316,11,25
인천서부교육지원청,42337,257,1240,251,1240,6,49
인천서부여성회관,42131,1802,1465,1744,1465,58,108
인천서부여성회관,42134,4251,4785,4076,4785,175,301
인천서창동우체국,39820,4582,9212,4518,9212,64,459
인천서창동우체국,39821,9939,2316,9858,2316,81,408
인천서창중학교,39767,5708,3540,5546,3540,162,308
인천서창중학교,39875,4472,2767,4398,2767,74,241
인천성모병원정문,40844,8691,10289,8543,10289,148,632
인천성모병원정문,40857,9421,7089,9292,7089,129,550
인천성모병원종점지주차장,40919,182,2334,155,2334,27,83
인천성모병원후문,40138,1904,7597,1821,7597,83,316
인천성모병원후문,40139,4353,1755,4264,1755,89,203
인천세무서,36169,5,27,5,27,0,1
인천세무서후문,36179,68,138,68,138,0,6
인천소방본부,37189,3636,8016,3508,8016,128,388
인천소방본부,37191,8587,4333,8355,4333,232,430
인천소방항공대,35809,118,10,112,10,6,4
인천소방항공대,35810,5,215,5,215,0,7
인천송도꿈유치원,38622,6903,33,6856,33,47,231
인천송도꿈유치원,38623,149,8598,107,8598,42,291
인천송일초등학교,38558,495,1324,469,1324,26,60
인천송일초등학교,38575,1272,986,1231,986,41,75
인천수산물센터,35069,6014,7092,5656,7092,358,436
인천스타트업파크,38390,1966,637,1943,637,23,86
인천스타트업파크,38394,873,2662,848,2662,25,117
인천시교육청 교육연수원,35774,1,0,1,0,0,0
인천시교육청 교육연수원,35782,0,3,0,3,0,0
인천시청후문,39290,13647,9264,13555,9264,92,763
인천시청후문,39292,11878,13007,11715,13007,163,829
인천아시아드주경기장(동문),89354,1213,24,1002,24,211,41
인천아시아드주경기장(동문),89359,151,1255,136,1255,15,46
인천아시아드테니스장,89356,705,40,644,40,61,24
인천아시아드테니스장,89357,20,1018,18,1018,2,34
인천여객터미널,89155,2,322,1,322,1,10
인천여자고등학교,38287,6755,8374,6640,8374,115,504
인천여자고등학교,38289,4822,4459,4605,4459,217,309
인천여자상업고등학교,35139,389,2408,380,2408,9,93
인천여자상업고등학교·이마트,35141,8850,2892,8695,2892,155,391
인천역(차이나타운),35178,37302,24626,36652,24626,650,2064
인천역(차이나타운),35179,27907,35095,27487,35095,420,2100
인천연세병원,42310,2531,2810,2475,2810,56,178
인천연합의원,42601,2736,3984,2644,3984,92,224
인천영어마을,42454,5260,3253,5214,3253,46,283
인천영어마을,42697,4295,9196,4222,9196,73,449
인천영어마을.파라곤센트럴,89437,273,95,273,95,0,12
인천영어마을앞,89436,36,87,36,87,0,4
인천예림학교(인천성모병원),40819,5927,6051,5849,6051,78,399
인천예림학교(인천성모병원),40820,6977,4288,6802,4288,175,375
인천예술고등학교,39332,872,519,859,519,13,46
인천예술고등학교,39533,524,705,512,705,12,40
인천옹진농협본점,35555,6786,4770,6505,4770,281,385
인천옹진농협본점,35797,846,1541,803,1541,43,79
인천의료원,36093,642,4687,641,4687,1,177
인천의료원,36107,15560,8923,15392,8923,168,816
인천의료원,36108,9129,12538,9030,12538,99,722
인천의료원,37458,5191,743,5157,743,34,197
인천이음중학교,89456,78,146,78,146,0,7
인천이음초등학교,89399,2870,413,2838,413,32,109
인천이음초등학교,89400,1536,6628,1502,6628,34,272
인천인력개발원,39071,1473,705,1469,705,4,72
인천인력개발원,39072,608,2023,595,2023,13,87
인천재능대정문,36172,9,3,9,3,0,0
인천재능대정문,36175,4,16,4,16,0,0
인천재능대후문,36173,1,1,1,1,0,0
인천재능대후문,36174,25,16,25,16,0,1
인천적십자병원(풍림아파트),38240,4039,4904,3922,4904,117,298
인천적십자병원(풍림아파트),38339,6189,4561,6022,4561,167,358
인천정보과학고등학교,35175,3372,4276,3278,4276,94,254
인천정보과학고등학교,35183,6432,1733,6165,1733,267,272
인천정보과학고등학교,35800,13,27,11,27,2,1
인천정보과학고등학교,36002,2555,5734,2478,5734,77,276
인천종합수산물센터,35074,4949,234,4718,234,231,172
인천준법지원센터·미추홀트루엘파크,37147,763,266,739,266,24,34
인천준법지원센터·미추홀트루엘파크,37148,87,760,85,760,2,28
인천지방법원,37096,4293,58,4204,58,89,145
인천지방법원북부지원입구,89434,304,61,304,61,0,12
인천지방법원북부지원입구,89435,6,292,6,292,0,9
인천지방중소기업청입구,39087,2950,1074,2934,1074,16,134
인천체육고등학교,89233,253,393,244,393,9,21
인천체육고등학교입구,89048,47,28,43,28,4,2
인천체육고등학교입구,89049,2,77,2,77,0,2
인천축구전용경기장,36184,76,19,50,19,26,3
인천축구전용경기장,37286,2186,2671,2064,2671,122,161
인천축구전용경기장,37303,2947,1714,2875,1714,72,155
인천축구전용경기장(서희스타힐스),37558,170,1592,163,1592,7,58
인천축산농협,40454,440,797,428,797,12,41
인천축산농협,40457,557,1015,535,1015,22,52
인천축산물시장,42010,1393,912,1357,912,36,76
인천축산물시장,42011,768,1190,757,1190,11,65
인천출입국·외국인청,35127,12689,1634,12523,1634,166,477
인천출입국·외국인청,35129,1056,10346,982,10346,74,380
인천터미널,37215,2025,14,1989,14,36,67
인천터미널사거리입구,39194,1323,4854,1311,4854,12,205
인천터미널역,37648,492,42,489,42,3,17
인천테크노밸리U1센터,40605,4543,6349,4444,6349,99,363
인천테크노밸리U1센터,40607,7581,4830,7460,4830,121,413
인천푸른빛유치원,89376,984,67,978,67,6,35
인천푸른빛유치원,89377,84,1066,81,1066,3,38
인천항신국제여객터미널,38652,888,471,880,471,8,45
인천항신국제여객터미널(하행),38662,355,832,313,832,42,39
인천해든초등학교,89410,1774,1006,1773,1006,1,92
인천해든초등학교,89411,1213,2554,1206,2554,7,125
인천해양과학고,38120,2026,1223,1969,1223,57,108
인천해양과학고,38566,610,290,584,290,26,30
인천향교.인천도호부청사,37124,5187,11901,5075,11901,112,569
인천향교.인천도호부청사,37125,9053,2009,8800,2009,253,368
인천향교유림회관,37059,13466,4578,13176,4578,290,601
인천향교유림회관,37062,8490,13117,8285,13117,205,720
인천환경공단입구,42930,513,140,494,140,19,21
인천힘찬종합병원,39628,5628,4132,5541,4132,87,325
인천힘찬종합병원,39629,3953,4062,3836,4062,117,267
인평자동차고,40149,13233,16427,13017,16427,216,988
인평자동차고,40151,1459,654,1442,654,17,70
인평자동차고,40152,383,1107,380,1107,3,49
인평자동차고,40787,17455,9428,17229,9428,226,896
인하국제의료센터,35643,0,6,0,6,0,0
인하대병원,35119,13233,9103,12951,9103,282,744
인하대병원,35121,4005,1680,3917,1680,88,189
인하대병원,35486,5524,5451,5344,5451,180,365
인하대병원입구,35846,6199,11555,6005,11555,194,591
인하대역,37596,17,8061,16,8061,1,269
인하대역(1번출구),37066,70044,70048,69165,70048,879,4669
인하대역(7번출구),37091,95615,68013,94602,68013,1013,5454
인하대역3번출구,37127,3626,18038,3546,18038,80,722
인하대역4번출구,37122,11772,4704,11552,4704,220,549
인하대정문,37099,14878,7069,14699,7069,179,731
인하대정문,37104,6580,16926,6428,16926,152,783
인하대후문,37165,48550,4182,48461,4182,89,1757
인하대후문,37166,1047,1267,1035,1267,12,77
인하대후문,37167,9800,48736,9648,48736,152,1951
인향아파트,40557,7688,603,7571,603,117,276
인향아파트,40559,388,6369,363,6369,25,225
인향아파트,41464,2605,158,2569,158,36,92
인향아파트,41465,89,5992,46,5992,43,202
인혜학교후문(원욱그린타운),41473,1648,552,1634,552,14,73
인혜학교후문(원욱그린타운),41518,626,3472,593,3472,33,136
인화1리마을회관,90211,58,31,55,31,3,2
인화리종점,43473,84,40,76,40,8,4
인화성입구,90063,0,13,0,13,0,0
인화성입구,90064,40,2,33,2,7,1
인화여고,37547,4576,4281,4348,4281,228,295
인화여고,37548,7730,12482,7556,12482,174,673
일신동행정복지센터,40200,7291,3577,7109,3577,182,362
일신동행정복지센터,40205,114,2468,111,2468,3,86
일신동행정복지센터,40220,3040,2818,2978,2818,62,195
일신시장,40207,4336,5451,4291,5451,45,326
일신시장,40210,5518,2573,5378,2573,140,269
일신주공,40866,426,1121,422,1121,4,51
일신주공109동,40868,6649,3840,6558,3840,91,349
임광그대가.서창자이아파트,39514,3667,1484,3652,1484,15,171
임광그대가.서창자이아파트,39515,302,3921,300,3921,2,140
임광그대가103동,92025,3105,3055,3054,3055,51,205
임송촌,43423,3,5,3,5,0,0
임송촌,43802,56,82,52,82,4,4
임학사거리,41283,508,1887,480,1887,28,79
임학역,41290,16892,22486,16708,22486,184,1312
임학역,41292,23218,13948,22877,13948,341,1238
임학지하차도앞사거리,41287,28,3567,28,3567,0,119
임학지하차도앞사거리,41288,2785,9,2783,9,2,93
입구지,35300,38,7,37,7,1,1
입구지,35751,11,18,11,18,0,0
입구지입구,35477,34,55,34,55,0,2
입구지입구,35478,58,4,57,4,1,2
자동차매매단지,11020,218,702,217,702,1,30
자동차매매단지,11021,560,229,556,229,4,26
자동차매매단지,36094,257,4450,243,4450,14,156
자동차매매단지,37459,3534,298,3516,298,18,127
자이금호힐스테이트,42849,331,3942,323,3942,8,142
자이금호힐스테이트,42850,2600,347,2500,347,100,98
자이더테라스1단지,89297,1295,478,1281,478,14,59
자이더테라스1단지,89298,651,1319,632,1319,19,65
자이더테라스2단지,42864,1477,2538,1454,2538,23,133
자이더테라스2단지,42871,2723,1119,2609,1119,114,128
자이더테라스2단지(209동),89460,5,172,4,172,1,5
작은구월사거리,39239,5832,5917,5741,5917,91,391
작은구월사거리,39240,6762,6372,6630,6372,132,437
작전1동주민센터,41113,14918,8310,14730,8310,188,774
작전동삼성홈플러스,41044,16699,29286,16506,29286,193,1532
작전동삼성홈플러스,41050,18625,9192,18368,9192,257,927
작전동풍림아파트,41090,283,1156,282,1156,1,47
작전서운동행정복지센터,41103,420,2561,392,2561,28,99
작전서운동행정복지센터,41104,2582,492,2523,492,59,102
작전역,41561,7330,5136,7296,5136,34,415
작전역,41562,5522,7444,5489,7444,33,432
작전역 서해그랑블,41047,2550,2513,2443,2513,107,168
작전역 서해그랑블,41414,1249,3188,1235,3188,14,147
작전역1번출구,41095,11191,15962,11038,15962,153,905
작전역2번출구,41092,4819,6582,4785,6582,34,380
작전역3번출구,41076,8599,4323,8527,4323,72,430
작전역4번출구,41062,15144,31987,14968,31987,176,1571
작전역5번출구,41057,58854,33498,58420,33498,434,3078
작전역6번출구,41433,3614,27520,3591,27520,23,1037
작전역7번출구,41401,25159,6089,25033,6089,126,1041
작전역8번출구,41093,10335,9942,10250,9942,85,675
작전중고.여고앞,41116,4081,3244,4004,3244,77,244
작전초등학교,41127,3168,2876,3099,2876,69,201
작전초등학교,41128,3032,2386,2982,2386,50,180
작전풍림아파트,41080,747,6152,695,6152,52,229
작전풍림아파트,41091,8234,3186,8124,3186,110,380
잔다리삼거리,35519,20,32,16,32,4,1
잔다리삼거리,35559,44,36,42,36,2,2
잔다리삼거리,35856,2,4,2,4,0,0
잔다리삼거리,35857,5,6,5,6,0,0
잔다리새마을,35866,34,48,23,48,11,2
잔다리새마을,35867,9,105,9,105,0,3
잔솔밭,43944,20,16,18,16,2,1
잠진도삼거리,35743,61,8,61,8,0,2
잠진도삼거리,35744,5,184,5,184,0,6
잠진도입구,35749,43,75,40,75,3,3
잠진도입구,35750,58,48,58,48,0,3
장경리공영주차장,44141,9,17,5,17,4,0
장경리공영주차장,44190,36,4,29,4,7,1
장경리해수욕장,44092,22,32,20,32,2,1
장경리해수욕장,44191,14,10,14,10,0,0
장곡.고촌고등학교,80066,188,93,187,93,1,9
장곡.고촌고등학교,80288,14,65,14,65,0,2
장곶돈대,43931,47,25,47,25,0,2
장곶돈대,43932,8,44,8,44,0,1
장곶횟집,43118,2,15,2,15,0,0
장곶횟집,43478,13,49,13,49,0,2
장구란,90349,2,9,2,9,0,0
장구란,90354,5,5,5,5,0,0
장기동,41345,1030,101,1029,101,1,37
장기동,41346,168,3708,164,3708,4,129
장기동,41347,2297,16412,2287,16412,10,623
장기동,41348,21417,2830,21215,2830,202,808
장도초등학교,39127,382,515,380,515,2,29
장도초등학교,39129,2224,860,2166,860,58,102
장릉입구,80046,14,127,12,127,2,4
장릉입구,80047,239,1,237,1,2,8
장미아파트,37044,6427,8521,6249,8521,178,498
장미아파트,37092,17893,9665,17615,9665,278,918
장미아파트,37094,9218,12537,9037,12537,181,725
장미아파트(19동)앞,37474,2189,2676,2135,2676,54,162
장미아파트(19동)앞,37540,2251,2862,2123,2862,128,170
장서초등학교,39965,2545,587,2508,587,37,104
장서초등학교,39966,971,7015,961,7015,10,266
장수.서창동행정복지센터,39580,4534,8878,4438,8878,96,447
장수.서창동행정복지센터,39581,8818,1903,8780,1903,38,357
장수공영차고지,39566,1780,781,1308,781,472,85
장수공영차고지,92064,676,191,12,191,664,28
장수교,39336,491,565,480,565,11,35
장수교(서창동입구),39337,290,1204,279,1204,11,49
장수동,39373,780,1938,762,1938,18,90
장수동,39391,1193,1296,1156,1296,37,82
장수동,39393,4186,5086,4112,5086,74,309
장수빌라,39577,447,1197,440,1197,7,54
장수사거리,39389,12545,3844,12339,3844,206,546
장수사거리,39397,146,2508,140,2508,6,88
장수사거리,39501,2766,7181,2703,7181,63,331
장수사거리,39542,5317,428,5188,428,129,191
장수주공(청소년수련원),39417,49,2157,47,2157,2,73
장수주공(청소년수련원),39424,3058,73,3002,73,56,104
장수초등학교,39342,3389,1809,3265,1809,124,173
장수초등학교,39352,1123,2611,1105,2611,18,124
장수파출소,39543,5,676,5,676,0,22
장승마루,90028,0,20,0,20,0,0
장승마루,90029,14,1,14,1,0,0
장승마을,43200,0,33,0,33,0,1
장승마을,43714,85,1,66,1,19,2
장승백이시장,39280,3795,1460,3738,1460,57,175
장승백이시장,39282,710,3985,699,3985,11,156
장아초등학교,39873,941,634,914,634,27,52
장아초등학교,39874,153,1716,116,1716,37,62
장안,43418,8,42,6,42,2,1
장안,43445,85,15,73,15,12,3
장안마을,43133,12,0,11,0,1,0
장안마을,43855,0,5,0,5,0,0
장안말(구초지분교)입구,90083,44,125,39,125,5,5
장안말(구초지분교)입구,90084,191,87,187,87,4,9
장안말(온천스파),43144,17,3,16,3,1,0
장안말(온천스파),43253,30,11,28,11,2,1
장안말(온천스파),43892,3,8,3,8,0,0
장안사거리,37285,16075,3261,15843,3261,232,644
장안사거리,37295,4610,17295,4460,17295,150,730
장안촌동쪽,43933,5,32,5,32,0,1
장암마을,90155,115,87,113,87,2,6
장암마을,90156,33,52,33,52,0,2
장애인복지관,37249,2462,2843,2415,2843,47,176
장애인종합복지관,43320,1,0,1,0,0,0
장애인종합복지관,43627,3,11,3,11,0,0
장인가구,39706,186,268,186,268,0,15
장자말,43142,2,13,2,13,0,0
장자말,43257,48,2,44,2,4,1
장자촌,43141,33,0,32,0,1,1
장자촌,43255,1,1,1,1,0,0
장전,43415,45,3,45,3,0,1
장전,43500,3,20,2,20,1,0
장정2리마을회관,43665,1,96,1,96,0,3
장정2리마을회관,43693,152,0,139,0,13,5
장지포,90238,3,11,3,11,0,0
장지포,90239,1,7,0,7,1,0
장천사거리,37282,1778,1967,1743,1967,35,124
장천사거리,37610,302,1163,286,1163,16,48
장천사거리,37651,289,1235,277,1235,12,50
장촌길 입구,90379,7,8,7,8,0,0
장촌길 입구,90382,19,5,19,5,0,0
장촌마을,35475,131,7,126,7,5,4
장촌마을,35476,9,122,7,122,2,4
장촌빌라,35321,163,17,158,17,5,6
장촌빌라,35397,18,120,18,120,0,4
장하,43184,4,40,3,40,1,1
장하,43204,61,4,60,4,1,2
장화교회앞,43121,38,37,35,37,3,2
장화교회앞,43539,46,29,44,29,2,2
장화리학생수련원,43426,30,84,29,84,1,3
장화리학생수련원,43474,29,10,27,10,2,1
장흥낚시터,43211,0,1,0,1,0,0
장흥낚시터,43890,5,2,5,2,0,0
장흥리종점,43643,31,23,26,23,5,1
장흥리종점,43888,24,20,18,20,6,1
장흥매점,43641,0,3,0,3,0,0
장흥매점,43891,2,0,2,0,0,0
장흥삼거리,43153,10,9,10,9,0,0
장흥삼거리,43881,6,14,6,14,0,0
장흥저수지(성공회.해든뮤지움),90081,174,110,172,110,2,9
장흥저수지(성공회.해든뮤지움),90082,42,171,34,171,8,7
재능대학교서문,36058,17403,24653,17044,24653,359,1401
재능대학교서문,36119,15220,14099,14979,14099,241,977
재활용품수집장,43165,0,5,0,5,0,0
저수지관리소,43264,40,1,38,1,2,1
저수지휴게소,43567,17,55,17,55,0,2
저수지휴게소,43763,0,1,0,1,0,0
적두마을(월곳교회),43190,22,0,19,0,3,0
적두마을(월곳교회),43709,2,33,2,33,0,1
적석사입구,43348,11,59,8,59,3,2
적석사입구,43847,88,9,79,9,9,3
전동교회,35199,7894,5496,7503,5496,391,446
전동교회,35200,2844,8793,2758,8793,86,387
전득이고개입구,90187,7,32,6,32,1,1
전득이고개입구,90188,9,41,8,41,1,1
전들,43477,61,0,61,0,0,2
전들,43835,2,72,2,72,0,2
전등사남문,43515,121,348,100,348,21,15
전등사남문,43893,295,84,294,84,1,12
전등사동문,43521,158,655,145,655,13,27
전등사동문,43895,484,363,477,363,7,28
전소,35231,6267,4735,6067,4735,200,366
전소,35232,6094,5514,5892,5514,202,386
전원미술관앞,43387,202,7,195,7,7,6
전원미술관앞,43810,8,230,8,230,0,7
전인연립(종점),40132,72,224,70,224,2,9
점촌,43414,86,0,69,0,17,2
점촌,43806,0,67,0,67,0,2
젓개마을,35828,14,44,10,44,4,1
젓개마을,35829,7,7,7,7,0,0
젓개마을입구,35322,11,11,8,11,3,0
정광아파트(병무청),37008,4533,38,4494,38,39,152
정광아파트(병무청),37009,7,4810,5,4810,2,160
정광아파트.만수주공11단지,39476,7247,7084,7187,7084,60,477
정광아파트.만수주공11단지,39477,7648,4663,7593,4663,55,410
정기무역,35083,2245,218,2102,218,143,82
정다운그린빌,92024,1367,3118,1353,3118,14,149
정든마을아파트,40055,1204,1987,1191,1987,13,106
정든마을아파트,40057,1818,1328,1802,1328,16,104
정병원,40413,4733,4444,4686,4444,47,305
정부인천지방합동청사,37386,35619,17669,35223,17669,396,1776
정부인천지방합동청사,37388,25406,31094,25053,31094,353,1883
정비단지,37005,2081,1672,2030,1672,51,125
정비단지,37006,919,2193,890,2193,29,103
정서진삼거리,89234,1,321,1,321,0,10
정석항공과학고,37168,25873,5348,25753,5348,120,1040
정석항공과학고,37170,8964,26415,8911,26415,53,1179
정수사입구,43404,65,13,64,13,1,2
정수사입구,43436,35,35,35,35,0,2
정왕IC(미정차),92007,2,0,2,0,0,0
정하,43183,60,14,59,14,1,2
정하,43208,4,36,4,36,0,1
제물포시장,37310,635,719,618,719,17,45
제물포시장,37311,871,796,859,796,12,55
제물포여자중학교,37288,4251,2705,4153,2705,98,231
제물포여자중학교,37290,6572,5347,6439,5347,133,397
제물포여자중학교,37298,10548,12567,10247,12567,301,770
제물포역,37355,55261,36152,54449,36152,812,3047
제물포역,37364,33600,24896,33199,24896,401,1949
제물포역,37496,34986,41788,34104,41788,882,2559
제물포역,37498,18328,6275,18154,6275,174,820
제물포역,37502,35149,42883,34684,42883,465,2601
제물포역(동양빌딩),37339,710,4645,694,4645,16,178
제물포중학교,42064,2317,2739,2256,2739,61,168
제물포중학교,42065,2834,1640,2790,1640,44,149
제운사거리(청년창업특화거리),37175,2823,4285,2736,4285,87,236
제운사거리(청년창업특화거리),37534,2346,4847,2253,4847,93,239
제일시장,37316,7893,6896,7827,6896,66,492
제일시장,37329,11298,11104,11137,11104,161,746
제일시장사거리,37667,1188,558,1145,558,43,58
제일주유소,57020,2402,1704,2352,1704,50,136
제일주유소,57021,1191,3594,1189,3594,2,159
제일풍경채,42833,2657,3018,2638,3018,19,189
제일풍경채1차정문앞,89350,2337,1347,2327,1347,10,122
제일풍경채2차,89349,17,407,17,407,0,14
제일풍경채2차321동앞,42866,3026,1090,2952,1090,74,137
제일풍경채2차321동앞,42873,313,1238,290,1238,23,51
제일풍경채2차323동앞,42891,5221,6148,5142,6148,79,378
제일풍경채2차331동앞,42989,1527,3857,1474,3857,53,179
제적봉앞마을,90060,0,3,0,3,0,0
제적봉입구,43654,3,32,3,32,0,1
제적봉입구,43686,4,0,4,0,0,0
조광교회입구,43533,3,0,3,0,0,0
조광교회입구,43868,0,37,0,37,0,1
조달청(한양2차아파트),37511,6214,14321,5954,14321,260,684
조달청비축기지,35114,1716,5300,1669,5300,47,233
조달청비축기지,35115,4625,1978,4590,1978,35,220
조동초등학교,39464,3279,1735,3250,1735,29,167
조동초등학교,39465,29,1236,27,1236,2,42
조리미입구,80068,1614,82,1614,82,0,56
조리미입구,80069,39,1474,39,1474,0,50
조바위,90350,3,27,3,27,0,1
조바위,90351,20,1,19,1,1,0
조산,43192,10,83,7,83,3,3
조산,43334,125,19,119,19,6,4
조산교회,43172,1,36,1,36,0,1
조산교회,43338,52,2,37,2,15,1
조산초등학교,43189,88,243,85,243,3,11
조산초등학교,43593,181,5,174,5,7,6
종갱이,43180,50,115,50,115,0,5
종갱이,43288,147,116,144,116,3,8
종근당,40002,396,17,396,17,0,13
종근당,40005,12,944,12,944,0,31
종근당.충정로역,11002,82,8210,82,8210,0,276
종로약국,57005,704,1034,688,1034,16,57
종로약국,57007,1902,811,1866,811,36,90
종생마을,80161,820,128,778,128,42,31
종생마을,80162,172,1251,161,1251,11,47
종점(병무청),37014,2912,42,2830,42,82,98
종합터미널,37242,48511,22553,47957,22553,554,2368
종합터미널,39177,14143,40923,13931,40923,212,1835
종현동정보화마을,62043,29,172,28,172,1,6
종현동정보화마을,62044,205,21,203,21,2,7
좌동교차로,89371,8,59,8,59,0,2
좌동마을,42452,130,23,128,23,2,5
좌동마을,89253,47,166,44,166,3,7
좌동마을입구,42456,35,124,35,124,0,5
좌동마을입구,42928,257,36,257,36,0,9
주거단지,35118,334,278,300,278,34,20
주거단지,35120,153,726,152,726,1,29
주공12단지,35082,792,199,789,199,3,33
주공12단지,35084,515,328,500,328,15,28
주공6단지후문,40453,4919,2833,4889,2833,30,258
주공뜨란채아파트,40708,4189,3472,4144,3472,45,255
주공뜨란채아파트,40803,3840,3321,3808,3321,32,238
주공아파트,40867,354,653,340,653,14,33
주물단지,42291,953,3634,949,3634,4,152
주안1동행정복지센터,37385,5948,7361,5875,7361,73,443
주안2동치안센터,37302,8362,4964,8262,4964,100,444
주안4동행정복지센터,37333,219,188,213,188,6,13
주안4동행정복지센터,37335,85,498,84,498,1,19
주안5동행정복지센터,37526,764,931,742,931,22,56
주안7동행정복지센터,37214,19898,19651,19543,19651,355,1318
주안7동행정복지센터,37216,21919,16470,21396,16470,523,1279
주안국가산단역,37583,6787,574,6778,574,9,245
주안국가산단역,37584,21,2024,16,2024,5,68
주안남초등학교,37283,7757,6951,7522,6951,235,490
주안남초등학교,37284,12894,5054,12656,5054,238,598
주안도서관,37341,114,158,114,158,0,9
주안도서관,37342,113,196,109,196,4,10
주안매매단지,37586,316,652,309,652,7,32
주안북부역,37418,19644,15491,19530,15491,114,1171
주안북부역,37420,17683,12949,17609,12949,74,1021
주안북초등학교,37417,4742,6842,4704,6842,38,386
주안사거리,37330,17509,12496,17033,12496,476,1000
주안사거리,37514,3433,8342,3410,8342,23,392
주안시범공단,39927,283,477,279,477,4,25
주안아파트,37207,989,2345,964,2345,25,111
주안아파트,37209,1347,1483,1310,1483,37,94
주안역,37387,81989,28688,80851,28688,1138,3689
주안역,37389,19964,81057,19621,81057,343,3367
주안역,37402,940,3906,933,3906,7,161
주안역,37506,24173,16818,23787,16818,386,1366
주안역센트레빌아파트,37430,8083,15366,7994,15366,89,781
주안역센트레빌아파트정문,37490,1055,938,1046,938,9,66
주안역환승정류장,37503,92513,64091,91718,64091,795,5220
주안역환승정류장,37617,131777,110260,131431,110260,346,8067
주안파크자이더플래티넘아파트,37201,14424,8245,14246,8245,178,755
주안파크자이더플래티넘아파트,37204,8750,15329,8503,15329,247,802
주안현대아파트,37358,18903,16554,18414,16554,489,1181
주원고개,39377,1295,3812,1198,3812,97,170
주원고개,39396,3805,9476,3702,9476,103,442
주적골,39510,635,2114,599,2114,36,91
주적골,39608,908,959,895,959,13,62
주택마을,90230,29,49,17,49,12,2
중고등학교,44106,20,48,10,48,10,2
중고등학교,44193,93,69,72,69,21,5
중고차매매단지엠파크허브,42038,422,758,414,758,8,39
중곡고개,43935,0,2,0,2,0,0
중구노인복지회관,35151,11920,10057,11638,10057,282,732
중구노인복지회관,35152,12688,11996,12372,11996,316,822
중구문화회관,35466,3,584,3,584,0,19
중구문화회관,35467,1715,210,1693,210,22,64
중구청,35157,2759,1737,2721,1737,38,149
중구청,35159,985,3506,951,3506,34,149
중구청소년수련관.하늘중학교,35824,2677,672,2489,672,188,111
중독고개,43936,42,25,32,25,10,2
중박골입구,44123,32,3,32,3,0,1
중박골입구,44194,21,0,20,0,1,0
중봉로교차로,89420,694,989,683,989,11,56
중봉로교차로,89421,243,202,241,202,2,14
중부고용노동청(인천고용센터),39222,673,845,670,845,3,50
중부고용노동청(인천고용센터),39223,768,586,758,586,10,45
중산고등학교,35868,139,497,133,497,6,21
중산고등학교,35869,421,304,392,304,29,24
중산교차로,35652,1025,393,991,393,34,47
중산교차로,35653,307,3009,283,3009,24,110
중산동,35305,1947,532,1895,532,52,82
중산동(까치빌라앞),35247,508,855,489,855,19,45
중산동(중촌),35272,533,1457,501,1457,32,66
중산동(중촌),35278,33,225,11,225,22,8
중산중고등학교,35817,202,264,189,264,13,15
중산중고등학교,35818,147,446,140,446,7,19
중산중학교,35656,1871,776,1707,776,164,88
중산중학교,35657,937,1227,875,1227,62,72
중앙공영아파트,41268,4547,1236,4401,1236,146,192
중앙공원사거리,39189,702,1170,693,1170,9,62
중앙방앗간,35852,4,3,4,3,0,0
중앙사료,42014,2027,1310,1993,1310,34,111
중앙사료,42015,421,953,419,953,2,45
중앙산부인과,70176,9,296,7,296,2,10
중앙산부인과,70230,395,69,372,69,23,15
중앙시장,90125,2000,496,1842,496,158,83
중앙시장.고려궁지입구,43067,862,1661,833,1661,29,84
중앙아파트,40409,707,645,696,645,11,45
중앙아파트,42315,3030,2229,2959,2229,71,175
중앙하이츠,41110,4157,11770,4061,11770,96,530
중앙호수공원입구(호반베르디움),89245,25,644,9,644,16,22
중원고등학교,55078,1880,632,1865,632,15,83
중촌,43252,159,6,150,6,9,5
중촌,43369,2,68,1,68,1,2
중촌교차로,35436,138,790,125,790,13,30
중촌교차로,35443,1118,264,1086,264,32,46
중혈마을,43176,5,35,5,35,0,1
중혈마을,43299,72,3,72,3,0,2
중흥S클래스,42832,2211,1444,2183,1444,28,121
중흥S클래스,42847,667,513,659,513,8,39
중흥S클래스1차,42844,406,965,400,965,6,45
중흥S클래스1차,42845,775,567,765,567,10,44
중흥S클래스2차,42771,5288,1268,5113,1268,175,218
중흥S클래스2차,42856,4040,823,3871,823,169,162
중흥마을.은하마을,55070,745,373,740,373,5,37
지랏돌,90071,163,28,162,28,1,6
지랏돌,90072,0,20,0,20,0,0
지산리입구,43310,3,1,3,1,0,0
지산리입구,43751,2,9,2,9,0,0
지산입구(용진),43538,28,3,28,3,0,1
지산입구(용진),43679,5,30,5,30,0,1
지산주택,38202,33,1267,19,1267,14,43
지석리마을회관,90274,5,7,5,7,0,0
지석리망향단입구,90273,4,6,4,6,0,0
지석리오현부락,90275,19,15,19,15,0,1
지석초등학교입구,90277,35,8,35,8,0,1
지식정보단지역,38373,7525,977,7514,977,11,283
지식정보단지역,38403,6140,983,6110,983,30,237
지식정보단지역,38404,286,5090,284,5090,2,179
지식정보단지역(4번출구),38380,465,9444,465,9444,0,330
진고개(5연대입구),43380,152,103,149,103,3,8
진고개(5연대입구),43794,29,150,29,150,0,5
진광횟집앞,43507,10,4,10,4,0,0
진광횟집앞,43541,6,9,6,9,0,0
진달래아파트,37600,4,818,3,818,1,27
진도로르빌아파트,37471,1785,3362,1766,3362,19,171
진두방앗간,44129,0,12,0,12,0,0
진두방앗간,44195,13,0,11,0,2,0
진산과학고등학교,40640,129,371,3,371,126,16
진산과학고등학교,40915,98,3,83,3,15,3
진산중학교,40575,1199,3190,1161,3190,38,146
진산초등학교,40614,904,3571,893,3571,11,149
진산초등학교,40633,176,198,2,198,174,12
진산초등학교,40914,295,12,183,12,112,10
진솔인더스트리,89447,29,1,21,1,8,1
진솔인더스트리,89448,0,30,0,30,0,1
진주5단지503동앞,42089,3588,3554,3541,3554,47,238
진주상가,42544,3858,278,3802,278,56,137
진주아파트2단지,42092,363,11523,355,11523,8,396
진주아파트2단지6동,42084,126,6934,123,6934,3,235
진주아파트3단지,42086,8271,182,8163,182,108,281
진주아파트4단지,42077,3599,164,3572,164,27,125
진표에너지,42548,5,366,1,366,4,12
진흥아파트,37190,3110,2512,3058,2512,52,187
진흥아파트,37193,2701,3720,2652,3720,49,214
진흥아파트,37240,6957,4235,6849,4235,108,373
진흥아파트,37243,5946,11003,5867,11003,79,564
진흥아파트,39297,7802,7866,7711,7866,91,522
집단에너지,39064,91,133,90,133,1,7
집단에너지시설,39065,108,147,106,147,2,8
짓절미,43485,31,25,29,25,2,1
짓절미,43713,11,13,10,13,1,0
찬우물,39179,1207,3681,1170,3681,37,162
찬우물,39188,2086,976,2036,976,50,102
찬우물,43048,144,295,127,295,17,14
찬우물약수터,43851,177,261,166,261,11,14
참빛감리교회,42437,17306,11288,16820,11288,486,953
참좋은집,36160,313,6,308,6,5,10
참좋은집,36161,4,354,1,354,3,11
창골,43549,209,127,206,127,3,11
창리,43052,172,279,163,279,9,15
창리,43053,267,281,262,281,5,18
창리,43054,256,302,243,302,13,18
창리,43902,554,392,508,392,46,31
창리,43903,1,0,1,0,0,0
창신초등학교,42620,2909,1499,2857,1499,52,146
창신초등학교,42621,2080,2155,2051,2155,29,141
창영어린이공원,36168,2,31,2,31,0,1
창후1리마을회관,43595,154,1,148,1,6,5
창후1리마을회관,43783,7,138,7,138,0,4
창후리입구,43604,184,11,173,11,11,6
창후리입구,43830,12,188,11,188,1,6
창후리종점,43774,40,115,39,115,1,5
창후정미소,43461,103,0,101,0,2,3
창후정미소,43600,9,68,7,68,2,2
채석장,38179,1142,471,1105,471,37,53
천곡,43409,177,1,162,1,15,5
천곡,43827,26,178,25,178,1,6
천촌,43411,2,94,2,94,0,3
천촌,43795,119,3,108,3,11,4
철곶,43653,4,10,2,10,2,0
철곶,43759,14,0,12,0,2,0
철산리검문소,43957,6,27,6,27,0,1
철산리검문소,43958,39,7,39,7,0,1
철산리입구,43685,17,19,17,19,0,1
철산리입구,43741,7,40,6,40,1,1
첨단초등학교,92014,323,3438,317,3438,6,125
청광플러스원102동앞,39946,2011,216,2011,216,0,74
청광플러스원아파트,39775,6204,2482,6121,2482,83,289
청광플러스원아파트,39786,1817,7449,1759,7449,58,308
청능로사거리,39622,43181,17003,42402,17003,779,2006
청능로사거리,39623,18624,41609,18137,41609,487,2007
청라1동행정복지센터,42744,13614,5670,13453,5670,161,642
청라1동행정복지센터,42745,7282,10986,7137,10986,145,608
청라2동행정복지센터,89039,3041,595,3001,595,40,121
청라2동행정복지센터,89042,1082,2919,1028,2919,54,133
청라3동행정복지센터,89374,1224,3788,1209,3788,15,167
청라3동행정복지센터,89375,4606,827,4591,827,15,181
청라BRT차고지입구,89336,164,279,3,279,161,14
청라BRT차고지입구,89337,679,140,532,140,147,27
청라고등학교,42784,2242,1183,2193,1183,49,114
청라고등학교,42785,1063,2232,989,2232,74,109
청라골프아카데미,89255,123,46,121,46,2,5
청라골프아카데미,89256,66,141,66,141,0,6
청라국제도서관,42922,69,229,55,229,14,9
청라국제도서관,42923,386,74,378,74,8,15
청라국제도시역,89270,33567,483,33443,483,124,1135
청라국제도시역(경명대로),89034,8182,11103,8142,11103,40,642
청라국제도시역(서부산단방향),89043,25468,28081,25310,28081,158,1784
청라국제도시역(청라국제교방향),89215,29212,20928,29042,20928,170,1671
청라국제어린이집,89289,326,35,311,35,15,12
청라국제업무단지(골드클래스),42984,723,603,720,603,3,44
청라꽃농원,42991,145,78,145,78,0,7
청라달튼국제학교,42895,833,1162,750,1162,83,66
청라달튼국제학교,89121,966,535,934,535,32,50
청라도,42931,8,108,8,108,0,3
청라도,89127,5,33,2,33,3,1
청라디이스트,42961,170,966,111,966,59,37
청라디이스트,89045,8,47,0,47,8,1
청라디이스트(562동),42962,1833,3783,1814,3783,19,187
청라디이스트(567동),89017,1072,289,1033,289,39,45
청라로데오시티포레안,89419,54,166,54,166,0,7
청라로봇랜드,89246,38,20,31,20,7,1
청라로봇랜드,89247,0,184,0,184,0,6
청라모아미래도아파트604동,89344,1695,952,1676,952,19,88
청라모아미래도아파트정문,89353,95,284,95,284,0,12
청라백세요양병원,42944,132,104,131,104,1,7
청라백세요양병원,89179,131,147,130,147,1,9
청라복합문화센터,89218,142,1252,140,1252,2,46
청라복합문화센터,89219,632,289,595,289,37,30
청라센텀로제비앙,89295,1329,1042,1327,1042,2,79
청라센텀로제비앙,89296,1180,1066,1163,1066,17,74
청라센텀로제비앙정문앞,89346,38,79,38,79,0,3
청라센트럴에일린의뜰,42834,4158,3469,4111,3469,47,254
청라센트럴에일린의뜰104동,42990,4477,1569,4399,1569,78,201
청라센트럴에일린의뜰106동,42892,9784,4855,9535,4855,249,487
청라스타필드,89417,23,31,23,31,0,1
청라스타필드,89418,64,480,61,480,3,18
청라시티프라디움,89334,1393,1678,1369,1678,24,102
청라시티프라디움,89335,2455,792,2395,792,60,108
청라우미린,42862,488,4535,466,4535,22,167
청라우미린아파트,89290,2956,9306,2931,9306,25,408
청라웰카운티221동,89288,39,317,37,317,2,11
청라웰카운티223동,42997,1301,226,1283,226,18,50
청라자이,42742,11885,3560,11656,3560,229,514
청라중앙호수공원입구,89021,12118,9345,12016,9345,102,715
청라중앙호수공원입구,89024,7892,12871,7856,12871,36,692
청라중학교,42848,1338,2038,1324,2038,14,112
청라초등학교,89281,5253,7017,5230,7017,23,409
청라초등학교,89282,5168,6328,5101,6328,67,383
청라파크자이상가,89299,691,944,661,944,30,54
청라파크자이상가,89300,668,588,664,588,4,41
청라푸르지오,89217,774,1180,763,1180,11,65
청라한양수자인레이크블루,89348,2454,1580,2404,1580,50,134
청라한양수자인레이크블루,89351,1909,1850,1899,1850,10,125
청라한화꿈에그린,89123,1554,774,1548,774,6,77
청라한화꿈에그린,89124,715,935,708,935,7,55
청라호반베르디움.포리공원,42899,1816,524,1795,524,21,78
청라호반베르디움.포리공원,42919,707,1955,688,1955,19,88
청라호수공원(남측),42861,2858,998,2765,998,93,128
청라호수공원(남측),42863,1349,2424,1301,2424,48,125
청라호수공원한신더휴,42870,5563,621,5335,621,228,206
청라호수공원한신더휴아파트,89291,13063,6109,12862,6109,201,639
청라힐스테이트,42987,891,2901,858,2901,33,126
청라힐스테이트,42988,3715,487,3539,487,176,140
청람중학교,89018,1768,2016,1736,2016,32,126
청람중학교,89019,2292,2320,2249,2320,43,153
청람초등학교,89279,5598,9085,5582,9085,16,489
청람초등학교,89280,9272,7365,9137,7365,135,554
청량중학교,38086,11388,4216,11138,4216,250,520
청련사입구,43766,54,199,54,199,0,8
청련사입구,43841,128,20,127,20,1,4
청룡정,41633,162,9,151,9,11,5
청룡정,41634,2,222,2,222,0,7
청소년수련관,42612,2582,28,2525,28,57,87
청소년수련관,42613,41,2841,12,2841,29,96
청소년수련관,43078,56,31,42,31,14,2
청소년수련관,43079,26,18,26,18,0,1
청소년수련관.어린이과학관,41307,12370,9343,12084,9343,286,723
청소년수련관.어린이과학관,41308,7121,9418,6919,9418,202,551
청송1단지.중흥S클래스,80090,126,155,124,155,2,9
청송1단지.중흥S클래스,80102,583,203,582,203,1,26
청송2.3단지,80089,104,119,104,119,0,7
청송2.3단지,80101,303,96,303,96,0,13
청송마을.성우오스타,80329,93,132,92,132,1,7
청송부락,90092,0,10,0,10,0,0
청송부락,90093,10,0,10,0,0,0
청양골,42775,4,59,4,59,0,2
청운대삼거리(하늘꿈교회),37433,5772,4477,5601,4477,171,341
청운대삼거리(하늘꿈교회),37500,3027,3545,2985,3545,42,219
청운대후문.한전제물포지사,37632,356,1149,343,1149,13,50
청운대후문.한전제물포지사,37633,150,1476,137,1476,13,54
청정주말농장,39852,3,200,3,200,0,6
청천농장,40538,127,1536,124,1536,3,55
청천농장,42511,1180,268,1147,268,33,48
청천농장(종점),40520,3802,32,3714,32,88,127
청천농장입구,40558,461,226,441,226,20,22
청천농장입구,40809,5,558,1,558,4,18
청천도서관,40426,1462,2097,1459,2097,3,118
청천도서관,40427,1024,714,983,714,41,57
청천동,40808,310,8,310,8,0,10
청천동무지개아파트,40617,909,3317,847,3317,62,140
청천동무지개아파트,40618,3227,894,3199,894,28,137
청천중학교,40449,1457,2545,1411,2545,46,133
청천중학교,40455,1302,2286,1270,2286,32,119
청천천공영주차장,40896,342,1402,335,1402,7,58
청천천공영주차장,41639,330,1423,328,1423,2,58
청천초등학교,40582,3185,5327,3054,5327,131,283
청천초등학교,40586,19579,6234,19224,6234,355,860
청천초등학교,40587,4547,12631,4436,12631,111,572
청천초등학교후문,40574,1480,12122,1453,12122,27,453
청천초등학교후문,40579,12624,1525,12452,1525,172,471
청천치안센터,40533,20615,11694,20252,11694,363,1076
청천치안센터,40537,7318,9258,7160,9258,158,552
청천푸르지오아파트,40488,11278,102,11014,102,264,379
청천푸르지오아파트,40515,12574,1267,12509,1267,65,461
청천푸르지오아파트,40516,1329,9517,1299,9517,30,361
청천푸르지오아파트,40811,7711,1464,7683,1464,28,305
청천푸르지오아파트,40812,785,4395,765,4395,20,172
청천푸르지오아파트,40894,21,2331,21,2331,0,78
청천하우스디아파트,40475,6280,1782,6171,1782,109,268
청천하우스디아파트,40477,550,4316,533,4316,17,162
청학동.한국전력남인천지사,38230,3330,3809,3203,3809,127,237
청학동.한국전력남인천지사,38239,7198,6462,6986,6462,212,455
청학사거리,38256,23115,13432,22752,13432,363,1218
청학사거리,38259,9090,15621,8963,15621,127,823
청학사거리,38509,1548,1833,1535,1833,13,112
청학아파트,38236,9143,5352,8969,5352,174,483
청학아파트,38341,6462,7568,6347,7568,115,467
청학중학교,38160,4139,5982,4005,5982,134,337
청학중학교,38161,3390,2109,3247,2109,143,183
청학중학교,38496,1635,849,1591,849,44,82
청학초등학교,38181,3094,3601,3000,3601,94,223
청학초등학교,38185,3328,2947,3218,2947,110,209
청학초등학교,38190,1711,2486,1549,2486,162,139
체육공원,90214,23,10,20,10,3,1
체육공원앞,35605,2,325,2,325,0,10
체육공원앞,35606,314,2,314,2,0,10
초은고등학교,89025,7309,6955,7256,6955,53,475
초은고등학교,89026,3720,8901,3652,8901,68,420
초정마을,41252,3541,2707,3465,2707,76,208
초정마을,41254,2366,1050,2310,1050,56,113
초지,43016,29,39,29,39,0,2
초지대교,43017,128,426,125,426,3,18
초지대교,43071,1253,374,1188,374,65,54
초지대교,43106,170,664,140,664,30,27
초지리,43026,95,199,73,199,22,9
초지리,43093,9,53,9,53,0,2
초지삼거리,43112,53,33,51,33,2,2
초지삼거리,43147,0,19,0,19,0,0
초지삼거리,43508,10,54,7,54,3,2
초지진,43024,18,98,18,98,0,3
초지진,43025,237,141,227,141,10,12
초지큰말,43260,29,0,28,0,1,0
초지큰말,43512,1,12,1,12,0,0
축현초등학교.인천시립박물관,38151,4889,2739,4809,2739,80,254
축현초등학교.인천시립박물관,38152,2502,4502,2448,4502,54,233
축협,43061,1287,626,1247,626,40,63
충렬사,43326,17,0,17,0,0,0
충렬사,43629,54,19,53,19,1,2
충성아파트,40117,770,2103,754,2103,16,95
충정로역2호선,22064,11162,93,11149,93,13,375
치마바위,43247,1,35,1,35,0,1
치마바위,43646,26,0,23,0,3,0
카페거리,35727,24,34,24,34,0,1
카페거리,35728,7,74,7,74,0,2
칼빈매니토바국제학교,38370,2009,4395,1976,4395,33,213
칼빈매니토바국제학교,38435,3612,553,3417,553,195,138
칼빈매니토바국제학교,38500,4747,2858,4638,2858,109,253
캐슬해모로,39845,745,95,727,95,18,28
캐슬해모로,39846,4832,514,4743,514,89,178
캐슬해모로,39848,365,577,344,577,21,31
캐슬해모로,39849,735,3035,719,3035,16,125
캠퍼스타운역,38419,10885,16386,10813,16386,72,909
캠퍼스타운역,38420,7110,7305,6978,7305,132,480
캠퍼스타운역(3번출구),38388,45,3122,39,3122,6,105
캠퍼스타운역(3번출구),38717,729,30,724,30,5,25
커넬워크,38415,896,2477,882,2477,14,112
커넬워크,38417,2832,1528,2792,1528,40,145
커넬워크(4동),38527,569,1328,545,1328,24,63
컨벤시아,38372,659,2272,641,2272,18,97
코세스물류창고,89197,70,8,70,8,0,2
코스모스아파트,42098,327,1084,317,1084,10,47
코오롱더프라우,38439,263,806,251,806,12,35
코오롱더프라우,38440,942,204,922,204,20,38
코오롱아파트작전중.고.여고,41117,3260,4421,3193,4421,67,256
"쿠팡16,17센터",35865,211,232,207,232,4,14
쿠팡물류센터,89157,1,460,1,460,0,15
큐티엘,90218,9,7,9,7,0,0
큰말,43937,7,0,7,0,0,0
큰말,43938,0,9,0,9,0,0
큰말,43949,8,7,8,7,0,0
큰무리선착장,35710,258,144,255,144,3,13
큰무리선착장,35712,454,611,454,611,0,35
큰방죽사거리,39144,2550,3368,2510,3368,40,197
큰방죽사거리,39145,1396,3130,1370,3130,26,150
큰방죽삼거리,39575,112,180,112,180,0,9
큰방죽삼거리,39576,99,505,99,505,0,20
큰산너머입구,44013,19,189,19,189,0,6
큰산너머입구,44014,268,14,268,14,0,9
킹스빌타운,41315,3056,3229,2999,3229,57,209
타운하우스공장.명진화학,89226,5,436,5,436,0,14
타운하우스공장.명진화학,89227,317,7,315,7,2,10
탄토 마을,90381,18,0,18,0,0,0
탄토마을,90378,15,26,14,26,1,1
탑재,43115,5,70,5,70,0,2
탑재,43327,318,231,312,231,6,18
탑재,43579,266,291,260,291,6,18
태경아파트,38275,8200,8672,7960,8672,240,562
태산.대진아파트,38294,2406,2580,2395,2580,11,166
태산아파트,41193,7355,11320,7198,11320,157,622
태산아파트,42227,77,178,76,178,1,8
태산아파트·하나아파트,41578,1324,1980,1319,1980,5,110
태양공단,42147,2538,1522,2518,1522,20,135
태양공단,42148,2985,2130,2923,2130,62,170
태양주택,40204,18,1167,15,1167,3,39
태영아파트,42298,3639,3656,3563,3656,76,243
태영아파트,42300,3754,3447,3620,3447,134,240
태평1차아파트,39241,3810,305,3810,305,0,137
태평1차아파트,39242,210,3736,210,3736,0,131
태평1차아파트,39516,9670,1932,9589,1932,81,386
태평1차아파트,39517,2252,10952,2228,10952,24,440
태평2차아파트,39225,12506,3795,12440,3795,66,543
태평2차아파트,39518,3486,8575,3398,8575,88,402
태평아파트,38083,7812,7217,7720,7217,92,500
태평아파트,41183,1178,206,1148,206,30,46
태평아파트.주안한신휴플러스아파트,37180,2807,4280,2714,4280,93,236
태평아파트.주안한신휴플러스아파트,37183,1288,1794,1239,1794,49,102
태평아파트1차(A),42326,4269,13060,4207,13060,62,577
태평아파트1차(B),42325,11610,3807,11469,3807,141,513
태평아파트2차(A),42317,2167,3482,2147,3482,20,188
태평아파트2차(B),42318,5276,2883,5200,2883,76,271
태평아파트입구,39274,127,1732,126,1732,1,61
태평아파트입구,39276,748,286,734,286,14,34
태평양산업,39066,2456,562,2451,562,5,100
태평양인천물류센터,42012,1780,2460,1776,2460,4,141
태화.두진아파트,39441,8700,6104,8629,6104,71,493
태화두진아파트,39445,7419,6778,7365,6778,54,473
태화아파트,37413,4870,4139,4835,4139,35,300
태화아파트,37416,6251,5210,6165,5210,86,382
태화아파트,40545,8957,3817,8770,3817,187,425
태화아파트,40810,1717,46,1715,46,2,58
태화한진아파트,41132,4817,2561,4804,2561,13,245
태화한진아파트612동,41135,1011,2688,977,2688,34,123
택리,43233,45,6,44,6,1,1
택리,43859,3,57,3,57,0,2
택리교회,43229,17,105,16,105,1,4
택리교회,43860,109,20,103,20,6,4
테니스장,40456,224,228,223,228,1,15
테일코리아,89430,201,64,199,64,2,8
테일코리아,89431,489,157,486,157,3,21
테크노파크IT센타,39726,746,2327,722,2327,24,102
테크노파크IT센타,39727,2371,2110,2293,2110,78,149
테크노파크IT센터,39938,3158,5411,3072,5411,86,285
테크노파크역,38421,28052,15008,27762,15008,290,1435
테크노파크역,38422,24261,25685,24030,25685,231,1664
토지금고,37114,8134,2181,7952,2181,182,343
토지금고,37115,3739,11282,3630,11282,109,500
토지금고시장,37102,17503,14136,17182,14136,321,1054
토지금고시장앞,37509,11169,9963,10994,9963,175,704
트러스(서구장애인직업재활시설),42809,338,2,326,2,12,11
트러스(서구장애인직업재활시설),42810,1,294,1,294,0,9
트레지움1단지.다니엘병원,55076,3054,974,2988,974,66,134
트레지움1단지.다니엘병원,55077,834,2123,830,2123,4,98
트루엘에코시티아파트(후문),42049,1546,1031,1526,1031,20,85
트루엘에코시티아파트(후문),42050,1329,1351,1292,1351,37,89
파라곤보타닉파크,89422,1604,6,1575,6,29,53
파라곤보타닉파크(고산터널),89395,910,294,909,294,1,40
파라다이스공원,43391,130,30,128,30,2,5
파라다이스공원,43828,16,174,13,174,3,6
파라다이스시티역,35748,0,18,0,18,0,0
팔도주유소,40175,243,282,237,282,6,17
팔도주유소,40774,10237,6871,9993,6871,244,570
팬더아파트,39968,329,2,329,2,0,11
팬더아파트,39980,3,305,1,305,2,10
펜션마을,90392,2,22,2,22,0,0
펜션마을,90393,8,0,8,0,0,0
평전,43258,1,46,1,46,0,1
평화전망대,43743,53,68,53,68,0,4
평화전망대,43760,49,8,46,8,3,1
포내교회,35874,2,1,2,1,0,0
포내교회,35875,2,26,2,26,0,0
포도마을,55039,2432,2698,2410,2698,22,171
포도마을사거리.현대백화점.이마트,55055,8954,9029,8884,9029,70,599
포도밭,43939,6,10,6,10,0,0
포도밭,43940,25,11,21,11,4,1
포레시안101동앞,39729,6015,5282,5894,5282,121,376
포레시안101동앞,39730,4367,3483,4311,3483,56,261
포스코타워앤쉐라톤호텔,38491,2597,1506,2546,1506,51,136
푸르지오더베뉴(3216동),89442,485,1831,477,1831,8,77
푸르지오더베뉴후문,89423,9,1339,9,1339,0,44
푸르지오더스카이,35844,2692,1299,2649,1299,43,133
푸르지오더스카이,35845,1690,1330,1658,1330,32,100
푸르지오더스카이256동,35508,1964,570,1902,570,62,84
푸르지오더스카이256동,35509,1064,1337,1013,1337,51,80
푸르지오월드마크,,7312,10366,7171,10366,141,589
푸르지오하버뷰,38456,142,471,141,471,1,20
푸르지오하버뷰,38522,1192,3191,1161,3191,31,146
푸른초장,90052,2,130,2,130,0,4
푸른초장,90053,87,2,87,2,0,2
풍류산,90129,0,17,0,17,0,0
풍류산,90130,41,0,38,0,3,1
풍림1단지정문,70007,6,1051,6,1051,0,35
풍림1차205동,35255,2509,4564,2465,4564,44,235
풍림1차205동,35256,7226,3421,7142,3421,84,354
풍림1차아파트,42969,12718,5085,12608,5085,110,593
풍림1차아파트,42970,4330,10910,4236,10910,94,508
풍림2.3차아파트,38350,10430,2340,10379,2340,51,425
풍림2단지,70010,11,1649,9,1649,2,55
풍림2차아파트,38049,4945,13893,4887,13893,58,627
풍림2차아파트,38050,7945,5602,7692,5602,253,451
풍림3단지정문,70003,132,281,117,281,15,13
풍림3차아파트,42366,8760,4838,8694,4838,66,453
풍림6단지,35124,2323,324,2253,324,70,88
풍림아이원,36114,210,1933,206,1933,4,71
풍림아이원,36115,7334,1730,7177,1730,157,302
풍림아이원,36121,2414,8734,2372,8734,42,371
풍림아이원,41441,4068,2202,3996,2202,72,209
풍림아이원1차·금호어울림아파트,42642,5891,16,5767,16,124,196
풍림아이원1차·금호어울림아파트,42646,26,5140,22,5140,4,172
풍림아이원2차아파트,42485,12661,76,12380,76,281,424
풍림아이원4차아파트,42645,14,4121,14,4121,0,137
풍림아이원아파트,37034,19458,9064,18966,9064,492,950
풍림아파트,36122,6396,568,6224,568,172,232
풍림아파트,37245,25148,7382,24590,7382,558,1084
풍림아파트,37246,6061,12575,5973,12575,88,621
풍림아파트,38255,3860,5170,3833,5170,27,301
풍림아파트,39162,8560,12528,8356,12528,204,702
풍림아파트,39163,13690,6459,13565,6459,125,671
풍림아파트,41374,2695,2757,2645,2757,50,181
풍림아파트,70008,746,9,730,9,16,25
풍림아파트(소래마을),39120,1314,3655,1260,3655,54,165
풍림아파트104동,40898,7532,6394,7361,6394,171,464
풍림아파트104동,40899,4877,5629,4855,5629,22,350
풍림아파트상가,70043,324,435,301,435,23,25
풍림아파트상가,70044,479,156,456,156,23,21
풍림엑슬루타워,42830,5697,7693,5676,7693,21,446
풍무역,80167,298,5544,298,5544,0,194
풍무역,80168,3833,284,3829,284,4,137
풍물시장,35054,442,1081,384,1081,58,50
풍물시장,35055,135,3,135,3,0,4
풍물시장,43941,132,6973,122,6973,10,236
풍산빌라 입구,90384,16,16,16,16,0,1
풍산특수금속,90219,12,2,12,2,0,0
프라임,39643,5132,1368,5109,1368,23,216
프리상뜨아파트,40230,106,4367,100,4367,6,149
프린피아통합물류센터,89235,253,9,250,9,3,8
하나개삼거리,35733,5,56,5,56,0,2
하나개삼거리,35734,21,56,21,56,0,2
하나개해수욕장,35737,482,1005,478,1005,4,49
하나글로벌캠퍼스,89444,108,299,105,299,3,13
하나글로벌캠퍼스,89445,110,3373,109,3373,1,116
하나금융그룹통합데이터센터,89265,173,1615,173,1615,0,59
하나금융그룹통합데이터센터,89294,216,85,214,85,2,10
하나로쇼핑,37118,3455,7495,3243,7495,212,365
하나모터스,89451,31,0,27,0,4,1
하나모터스,89452,3,90,0,90,3,3
하나아파트,37052,9152,2859,9047,2859,105,400
하나아파트,40546,1115,1384,1111,1384,4,83
하나아파트,41250,5789,6730,5669,6730,120,417
하나아파트,41574,1855,19,1820,19,35,62
하늘도시중심상가,35821,2221,401,2111,401,110,87
하늘도시중심상가,35822,423,2285,417,2285,6,90
하늘문화센터,35826,0,44,0,44,0,1
하늘문화센터,35827,22,0,20,0,2,0
하늘문화센터입구,35766,1,44,1,44,0,1
하늘문화센터입구,35767,7,1,7,1,0,0
하늘중학교,35823,512,1341,478,1341,34,61
하늘초등학교후문,35499,365,212,347,212,18,19
하늘초등학교후문,35500,148,685,101,685,47,27
하늘휴게소,70220,2545,9117,2541,9117,4,388
하늘휴게소,70221,8342,2704,8336,2704,6,368
하룩,43157,50,199,41,199,9,8
하룩,43281,212,42,206,42,6,8
하리마을회관,90243,0,14,0,14,0,0
하리마을회관,90244,16,2,11,2,5,0
하리선착장,90240,5,23,5,23,0,0
하야동,41438,637,768,630,768,7,46
하야동,41439,693,1017,676,1017,17,57
하얀마을,55035,2402,2569,2386,2569,16,165
하얀집민박,43440,20,10,18,10,2,1
하얀집민박,43497,4,21,4,21,0,0
하얏트호텔,35028,1014,7677,994,7677,20,289
하얏트호텔,35206,1664,3581,1642,3581,22,174
하우고개,43275,47,125,45,125,2,5
하우고개,43577,136,49,110,49,26,6
하우스앞,43174,47,2,45,2,2,1
하우스앞,43231,2,30,2,30,0,1
하우스토리,41569,181,321,159,321,22,16
하우스토리,41570,176,1527,144,1527,32,56
하우스토리,41606,516,586,513,586,3,36
하우스토리,41626,723,449,720,449,3,39
하우스토리만수아파트,39301,1723,1010,1668,1010,55,91
하일부락입구,43971,1,3,1,3,0,0
하점공단,43448,0,38,0,38,0,1
하점공단,43755,17,48,16,48,1,2
하점면사무소,43738,281,123,276,123,5,13
하점면사무소,43834,103,217,96,217,7,10
하점순복음교회,90222,198,7,191,7,7,6
하점순복음교회,90223,2,43,2,43,0,1
하점우체국,43817,570,109,530,109,40,22
하점우체국,43838,95,651,91,651,4,24
하점초등학교,43739,2,65,2,65,0,2
하점초등학교,43836,140,11,122,11,18,5
하정초등학교,40044,1264,618,1232,618,32,62
학마을서원아파트,41652,156,121,155,121,1,9
학마을한진아파트정문,41293,2211,3214,2185,3214,26,180
학산사거리,37025,6800,260,6621,260,179,235
학산사거리,37027,240,3558,222,3558,18,126
학산사거리,37562,1610,1278,1535,1278,75,96
학산소극장,37169,18658,2950,18558,2950,100,720
학산소극장,37173,6703,15969,6660,15969,43,755
학생안전체험관,39284,2091,4389,2027,4389,64,216
학익.원흥아파트,37015,1921,76,1878,76,43,66
학익2동행정복지센터,37150,13404,6830,13021,6830,383,674
학익2동행정복지센터,37151,7381,13889,7196,13889,185,709
학익고등학교,37029,10100,2949,9870,2949,230,434
학익고등학교,37505,3043,10551,2953,10551,90,453
학익동구치소,37139,232,810,230,810,2,34
학익동성당앞,37630,1510,32,1450,32,60,51
학익동성당앞,37631,105,660,103,660,2,25
학익사거리,37058,13,409,11,409,2,14
학익사거리,37075,3048,1399,2952,1399,96,148
학익사거리,37077,2105,5929,2048,5929,57,267
학익사거리(동아풍림아파트),37084,12515,5014,12255,5014,260,584
학익사거리(동아풍림아파트),37089,10568,10011,10298,10011,270,685
학익시장,37106,15268,5364,14973,5364,295,687
학익시장,37112,3924,13425,3848,13425,76,578
학익시장(법원검찰청),37080,10182,4469,9909,4469,273,488
학익시장앞,37082,4383,5210,4319,5210,64,319
학익여자고등학교,37140,700,1232,681,1232,19,64
학익여자고등학교,37566,504,1153,502,1153,2,55
학익풍림아파트,37487,14,2691,14,2691,0,90
한가라지고개,90157,5,2,5,2,0,0
한가라지고개,90158,5,19,5,19,0,0
한가라지입구,90159,6,7,6,7,0,0
한가라지입구,90160,1,8,1,8,0,0
한가람마을우미린.호수이편한세상,80318,988,2988,985,2988,3,132
한강센트럴블루힐.모아엘가2차,80375,256,383,256,383,0,21
한국가스공사,39061,732,750,708,750,24,49
한국가스공사,89273,134,504,133,504,1,21
한국가스공사,89274,83,477,82,477,1,18
한국가스공사인천지역본부,89114,24,59,14,59,10,2
한국가스공사인천지역본부,89115,20,44,20,44,0,2
한국건설생활환경시험연구원,39312,446,349,410,349,36,26
한국건설생활환경시험연구원,39315,745,2958,735,2958,10,123
한국공항공사,25002,99,1273,97,1273,2,45
한국공항공사,25144,24,66,22,66,2,3
한국국토정보공사인천북부지사,42278,5297,6407,5169,6407,128,390
한국국토정보공사인천북부지사,42280,6405,3278,6281,3278,124,322
한국글로벌셰프고등학교,43246,191,155,176,155,15,11
한국글로벌셰프고등학교,43381,30,118,29,118,1,4
한국도심공항터미널,35400,9,107,8,107,1,3
한국도심공항터미널,35408,27,115,19,115,8,4
한국도심공항터미널,35417,87,8,76,8,11,3
한국도심공항터미널앞,35645,51,7,47,7,4,1
한국마쓰이,39055,997,1613,996,1613,1,87
한국마쓰이,39057,3532,1652,3520,1652,12,172
한국만화박물관,40583,5391,11192,5296,11192,95,552
한국무역센터.삼성역,23201,2519,9,2519,9,0,84
한국무역센터.삼성역,23251,101,1959,101,1959,0,68
한국산업단지공단,39060,917,73,911,73,6,33
한국산업단지공단,39067,42,877,42,877,0,30
한국생산기술연구원,38448,373,595,352,595,21,32
한국생산기술연구원(주조기술센터),42271,411,619,407,619,4,34
한국생산기술연구원(주조기술센터),42719,370,283,366,283,4,21
한국샤프(로얄금속),40600,2413,3598,2391,3598,22,200
한국선교역사기념관,40673,2139,825,2059,825,80,98
한국아파트,37017,1606,8183,1535,8183,71,326
한국아파트,38154,2964,1632,2927,1632,37,153
한국아파트,40714,128,2230,113,2230,15,78
한국아파트,40715,3061,98,3041,98,20,105
한국아파트,40790,15685,16141,15477,16141,208,1060
한국아파트,40791,15574,11978,15411,11978,163,918
한국아파트,40792,3840,13740,3777,13740,63,586
한국아파트,40816,11541,9634,11415,9634,126,705
한국아파트,41206,6573,3957,6469,3957,104,351
한국아파트,41208,2640,4527,2554,4527,86,238
한국아파트,80057,2205,48,2203,48,2,75
한국전력,42947,79,829,79,829,0,30
한국지엠청라주행시험장,89412,103,379,101,379,2,16
한국지엠청라주행시험장,89413,375,227,368,227,7,20
한국지엠출고문,40560,3738,7130,3698,7130,40,362
한국지엠출고문,40570,5365,3735,5332,3735,33,303
한국콘베어공업,92049,10,0,10,0,0,0
한국타이어인천물류센터,89221,448,1261,434,1261,14,56
한국타이어인천물류센터,89222,492,882,465,882,27,45
한국특수주물(주),42575,434,337,433,337,1,25
한국폴리텍2대학남인천캠퍼스,37448,973,974,969,974,4,64
한국폴리텍2대학남인천캠퍼스,37450,756,553,754,553,2,43
한남시티플라자,40253,20926,12039,20663,12039,263,1098
한들마을입구(유아교육진흥원),42370,708,3747,671,3747,37,148
한들마을입구(유아교육진흥원),42371,2335,939,2278,939,57,109
한라비발디,35459,7790,2994,7650,2994,140,359
한라비발디,35460,7041,14386,6851,14386,190,714
한라비발디,42878,697,13,694,13,3,23
한라비발디,42879,30,326,30,326,0,11
한라비발디,89180,1756,1381,1732,1381,24,104
한라비발디,89181,1584,2650,1542,2650,42,141
한라비발디정문,89373,32,1309,28,1309,4,44
한라비발디후문.화성파크드림,35658,615,1309,548,1309,67,64
한라시멘트,35291,124,477,97,477,27,20
한라아파트,39117,1340,4186,1271,4186,69,184
한라아파트,39118,6129,1812,5915,1812,214,264
한림병원,41130,13683,8856,13560,8856,123,751
한림병원,41131,9940,15361,9829,15361,111,843
한미반도체,42754,718,1403,708,1403,10,70
한미반도체,42755,213,338,202,338,11,18
한빛초교앞,39773,1531,7475,1500,7475,31,300
한빛초교앞,39774,6522,2752,6459,2752,63,309
한사랑어린이집,42461,12,70,12,70,0,2
한성아파트,89020,829,1306,822,1306,7,71
한성자동차학원,42091,335,779,335,779,0,37
한수조경,43681,8,6,6,6,2,0
한수조경,43882,6,1,2,1,4,0
한스엔지니어링,42276,414,132,407,132,7,18
한스엔지니어링,42279,420,559,417,559,3,32
한신더휴스카이파크,35654,1026,954,980,954,46,66
한신더휴스카이파크,35655,1720,699,1694,699,26,80
한신더휴테라스,35761,82,40,81,40,1,4
한신더휴테라스,35762,14,59,14,59,0,2
한신빌리지(A),42249,767,2625,757,2625,10,113
한신빌리지(B),42246,4180,852,4113,852,67,167
한신빌리지(C),42229,2623,605,2591,605,32,107
한신빌리지아파트,42230,502,1125,489,1125,13,54
한신삼부아파트,40806,1922,2844,1898,2844,24,158
한신아파트,37262,5246,3806,5202,3806,44,301
한신아파트,37264,8677,9997,8489,9997,188,622
한신아파트,37267,12568,9483,12438,9483,130,735
한신아파트,41066,1907,1198,1892,1198,15,103
한신아파트,41067,2074,1720,2054,1720,20,126
한신아파트,42095,38,1069,26,1069,12,36
한신휴아파트,40245,4636,132,4575,132,61,158
한신휴아파트,42105,40242,17752,39621,17752,621,1933
한신휴아파트,42106,3115,2190,3055,2190,60,176
한양2차아파트,37512,13010,4459,12776,4459,234,582
한양2차아파트,38055,5095,3896,4996,3896,99,299
한양2차아파트37동,38058,1651,1167,1642,1167,9,93
한양공구,39664,104,0,103,0,1,3
한양공구,39753,0,63,0,63,0,2
한양공구,42071,864,7129,860,7129,4,266
한양쇼핑,40331,1468,8221,1376,8221,92,322
한양쇼핑,40333,5767,3436,5663,3436,104,306
한양수자인,35450,2397,321,2321,321,76,90
한양수자인,42868,4508,2306,4435,2306,73,227
한양수자인,42893,3222,3256,3052,3256,170,215
한양수자인(후문),35537,3097,583,3052,583,45,122
한양아파트,37076,2042,5697,1988,5697,54,257
한양아파트,37079,5638,642,5574,642,64,209
한양아파트,40269,466,289,451,289,15,25
한양아파트,40310,15707,4594,15524,4594,183,676
한양아파트,40356,17038,10872,16859,10872,179,930
한양아파트,40905,37,472,35,472,2,16
한양아파트2차,38062,3699,6163,3619,6163,80,328
한양화학,42523,3337,967,3249,967,88,143
한일베라체,42839,5869,1253,5682,1253,187,237
한일베라체,42865,1092,2310,1048,2310,44,113
한일베라체,42948,4206,1794,4105,1794,101,200
한일아파트,41295,955,2205,942,2205,13,105
한일아파트,41296,2079,1076,1991,1076,88,105
한일아파트,80195,78,1589,78,1589,0,55
한일튜브(주),42576,428,306,427,306,1,24
한전사택,44090,35,39,32,39,3,2
한전사택,44197,1,0,1,0,0,0
한전온수출장소,43012,237,424,210,424,27,22
한주글로벌,89306,10,384,10,384,0,13
한진,38540,0,390,0,390,0,13
한진,38541,358,5,356,5,2,12
한진아파트,38016,26507,16522,26334,16522,173,1434
한진아파트,41355,246,511,240,511,6,25
한진아파트후문,41300,2570,594,2562,594,8,105
한풍산업,39014,434,874,423,874,11,43
한화2차,40363,3425,1489,3352,1489,73,163
한화꿈에그린,42860,1151,423,1116,423,35,52
한화꿈에그린,42872,392,1011,349,1011,43,46
한화꿈에그린정문,89372,2791,1897,2684,1897,107,156
한화아파트,40351,12912,8447,12668,8447,244,711
한화아파트,40379,2523,2008,2503,2008,20,151
한화아파트,40380,4064,2120,4005,2120,59,206
한화아파트,41375,4106,3030,4004,3030,102,237
한화지구공원앞,39654,1515,1033,1467,1033,48,84
한희빌딩,39311,1790,5300,1697,5300,93,236
함박도서관,38286,3994,2507,3929,2507,65,216
함박도서관,38742,323,1478,322,1478,1,60
함박마을,38277,5463,2094,5225,2094,238,251
함박마을문화복지센터,38291,3291,1742,3224,1742,67,167
함박마을문화복지센터,38741,252,1651,249,1651,3,63
함박마을입구,38285,2679,8810,2549,8810,130,382
함허동천,43352,4,52,4,52,0,1
함허동천,43403,81,7,81,7,0,2
합동청사역,35207,20535,3244,20394,3244,141,792
합정역,14220,200,11943,200,11943,0,404
합정역,23029,231,33503,231,33503,0,1124
합정역,23030,42747,607,42688,607,59,1445
항동7가버스차고지,35609,1308,31,840,31,468,44
항동7가버스차고지,35610,537,783,89,783,448,44
항동7가버스차고지(삼거리),35704,486,559,17,559,469,34
항동7가버스차고지(삼거리),35705,1118,39,937,39,181,38
항운아파트,35065,15760,4028,15389,4028,371,659
항운아파트,35481,1195,8024,1136,8024,59,307
항운아파트,35602,302,2015,301,2015,1,77
항진축산,39056,783,1827,779,1827,4,87
항진축산,39058,1935,1020,1930,1020,5,98
항청리종점,43558,137,76,112,76,25,7
항포,90247,0,3,0,3,0,0
항포,90248,34,4,34,4,0,1
해광병원,40292,67,2389,63,2389,4,81
해넘이마을,90135,29,17,29,17,0,1
해넘이마을,90136,40,38,38,38,2,2
해돋이공원,38008,44,247,42,247,2,9
해돋이공원,38010,438,776,432,776,6,40
해돋이공원,38718,46,71,44,71,2,3
해돋이도서관,38729,218,55,215,55,3,9
해돋이도서관,38730,33,536,33,536,0,18
해뜨는집앞,35531,9,28,9,28,0,1
해뜨는집앞,35726,73,4,72,4,1,2
해망,90352,5,4,2,4,3,0
해망,90353,9,12,9,12,0,0
해맞이공원앞,35616,198,608,188,608,10,26
해맞이공원앞,35617,393,126,389,126,4,17
해명초등학교앞,90179,20,30,20,30,0,1
해명초등학교앞,90180,26,131,25,131,1,5
해모로월드뷰,39794,1149,302,1117,302,32,48
해모로월드뷰,39805,445,755,431,755,14,40
해물탕거리,40782,3535,1897,3451,1897,84,181
해병2사단.향동,80054,849,551,842,551,7,46
해사고등학교,35503,1325,17,1290,17,35,44
해사고등학교.한국이민사박물관,35126,30,2376,30,2376,0,80
해서초등학교,41166,871,660,852,660,19,51
해서초등학교,41168,543,1610,526,1610,17,71
해성단조,42813,70,1,68,1,2,2
해송노인요양병원,35552,2,43,2,43,0,1
해송노인요양병원,35553,7,2,4,2,3,0
해수워터피아,42082,4331,677,4264,677,67,166
해수워터피아,42083,1494,7107,1494,7107,0,286
해안도로신항만교,39001,234,678,228,678,6,30
해안도로신항만교,39002,766,579,763,579,3,44
해암약수,90161,25,10,24,10,1,1
해암약수,90162,4,19,4,19,0,0
해양경찰청,38014,987,3526,937,3526,50,150
해양경찰청,38015,6480,2991,6415,2991,65,315
해양경찰청,38411,8253,6184,8177,6184,76,481
해양기계,39532,33,33,33,33,0,2
해양기계,39696,5,190,5,190,0,6
해오름민박,43413,81,49,76,49,5,4
해오름민박,43442,30,56,30,56,0,2
해원고등학교,42964,23,626,19,626,4,21
해원중학교,42972,1881,64,1737,64,144,64
해원중학교,42973,89,751,82,751,7,28
해원중학교후문,42965,1646,443,1569,443,77,69
해피타운앞,44139,6,2,4,2,2,0
해피타운앞,44198,39,58,33,58,6,3
해피하임.기업은행앞,42738,13,1469,13,1469,0,49
핸즈코퍼레이션,89262,21,2372,8,2372,13,79
핸즈코퍼레이션,89263,13,86,9,86,4,3
햇내로공원입구,35777,26,5,26,5,0,1
햇내로공원입구,35784,3,43,1,43,2,1
행복마을입구,35687,12,3,11,3,1,0
행복마을입구,35690,22,55,22,55,0,2
행자골,43350,2,8,2,8,0,0
행자골,43583,14,2,14,2,0,0
행정복지센터사거리,40332,709,3019,693,3019,16,124
향나무골,43131,14,7,14,7,0,0
향나무골,43648,15,19,15,19,0,1
향동해병2사단,80055,851,1718,816,1718,35,85
향촌휴먼시아2단지,39741,9269,14624,9178,14624,91,796
허브주유소,35446,457,607,438,607,19,35
허브주유소,35447,494,5066,482,5066,12,185
허튼개,90119,3,4,2,4,1,0
허튼개,90120,2,2,2,2,0,0
헤나무,43199,1,38,1,38,0,1
헤나무,43317,56,3,54,3,2,1
혁이네슈퍼,40738,60,747,54,747,6,26
혁이네슈퍼,40739,362,35,339,35,23,13
현광아파트,37007,1934,23,1922,23,12,65
현광아파트,37488,9,2462,4,2462,5,82
현광아파트,39380,16681,17516,16501,17516,180,1139
현광아파트,41071,5705,1598,5619,1598,86,243
현광아파트,41432,3246,6054,3211,6054,35,310
현광아파트,42258,115,754,111,754,4,28
현광아파트,42260,713,212,691,212,22,30
현광아파트(호산부인과),39376,31777,15902,31337,15902,440,1589
현광아파트후문,37560,2936,21,2898,21,38,98
현광아파트후문앞,37559,105,1466,9,1466,96,52
현대.태화아파트,41402,320,3696,306,3696,14,133
현대102동,40146,2914,1131,2880,1131,34,134
현대121동,40137,5432,810,5328,810,104,208
현대1단지관리사무소,40740,346,2530,336,2530,10,95
현대1차아파트,38061,6980,3987,6786,3987,194,365
현대1차아파트,41365,9246,679,9185,679,61,330
현대1차아파트정문,41367,101,326,95,326,6,14
현대207동,40168,754,9987,729,9987,25,358
현대209동,40167,10313,665,10141,665,172,365
현대2차아파트,38173,2086,2849,2050,2849,36,164
현대2차아파트,41106,859,4262,845,4262,14,170
현대2차아파트,41112,8333,496,8211,496,122,294
현대2차아파트,41366,433,5435,418,5435,15,195
현대2차아파트정문,41364,478,6128,469,6128,9,220
현대310동(서중학교),40097,1163,2751,1112,2751,51,130
현대3단지,40127,7151,6476,7001,6476,150,454
현대3단지,40129,7919,8316,7770,8316,149,541
현대3차아파트,38168,17892,11637,17268,11637,624,984
현대3차아파트,38342,17790,16940,17302,16940,488,1157
현대4차아파트,38158,2188,2293,2134,2293,54,149
현대4차아파트,38183,2673,4195,2604,4195,69,228
현대4차아파트,38186,3968,1438,3861,1438,107,180
현대5차,40405,11210,6483,11028,6483,182,589
현대5차,40408,6941,4453,6846,4453,95,379
현대5차아파트,38176,3992,1604,3823,1604,169,186
현대동부시장,36041,11405,5146,10987,5146,418,551
현대모닝.임광그대가아파트,39579,7442,2910,7338,2910,104,345
현대백화점,22003,5007,22,4994,22,13,167
현대슈퍼,43376,234,19,217,19,17,8
현대슈퍼,43617,5,58,5,58,0,2
현대시장,36042,10987,6459,10691,6459,296,581
현대시장,36043,6757,8721,6530,8721,227,515
현대시장,36118,7328,9710,7195,9710,133,567
현대써비스,42021,4062,2942,4025,2942,37,233
현대아파트,35396,124,11,124,11,0,4
현대아파트,37154,3194,8550,3159,8550,35,391
현대아파트,37161,7968,3640,7844,3640,124,386
현대아파트,39267,5826,5416,5731,5416,95,374
현대아파트,39271,6030,3365,5898,3365,132,313
현대아파트,40112,37318,26378,36608,26378,710,2123
현대아파트,40681,2242,7132,2164,7132,78,312
현대아파트,40682,7850,1861,7775,1861,75,323
현대아파트,40737,1065,2548,1052,2548,13,120
현대아파트,40788,37620,34643,37132,34643,488,2408
현대아파트,43082,42,430,42,430,0,15
현대아파트,43083,440,118,437,118,3,18
현대아파트.통진도서관,80135,143,1051,137,1051,6,39
현대아파트.통진도서관,80136,1092,187,1083,187,9,42
현대아파트105동,40734,145,1005,131,1005,14,38
현대아파트105동,40735,722,358,715,358,7,36
현대아파트113동,40105,10228,5938,10058,5938,170,538
현대아파트116동,40732,1798,449,1779,449,19,74
현대아파트119동,40733,68,2299,64,2299,4,78
현대아파트120동앞,40140,473,4792,449,4792,24,175
현대오일뱅크,41459,1664,1032,1650,1032,14,89
현대자동차빌딩앞,40103,6244,13224,6084,13224,160,648
현대자동차서비스,42032,8111,2277,8058,2277,53,346
현대자동차서비스,42033,11395,7437,11339,7437,56,627
현대제철,36086,701,1151,692,1151,9,61
현대제철,36123,3061,756,3022,756,39,127
현대제철정문,36133,508,1315,479,1315,29,60
현대철강레이져,90220,2,5,2,5,0,0
현대철강레이져,90221,21,0,21,0,0,0
현송중학교,38744,986,338,982,338,4,44
현송중학교,38745,401,835,387,835,14,41
형제마트,40004,593,1970,579,1970,14,85
형제마트,40006,1720,579,1690,579,30,76
혜덕,90217,21,7,20,7,1,0
혜성프라자,40393,25092,14251,24740,14251,352,1311
혜성프라자,40395,15663,17960,15407,17960,256,1120
호구포역,39784,6283,7018,6244,7018,39,443
호구포역,39785,10148,8749,10106,8749,42,629
호구포역2번출구,92040,1226,307,1223,307,3,51
호명사입구,40093,10,448,3,448,7,15
호박골,43437,36,43,32,43,4,2
호박골,43784,26,20,20,20,6,1
호박골사거리,43123,9,36,9,36,0,1
호박골사거리,43124,40,2,38,2,2,1
호박골사거리,43706,12,198,11,198,1,7
호박골사거리,43804,72,17,71,17,1,2
호반베르디움,42855,425,5252,412,5252,13,189
호반베르디움14단지,42880,1040,4323,944,4323,96,178
호반베르디움214동앞,42998,204,761,193,761,11,32
호반베르디움2차,89112,1750,1261,1731,1261,19,100
호반베르디움2차,89113,1250,1306,1235,1306,15,85
호반베르디움3차아파트,42743,2812,7346,2740,7346,72,338
호반베르디움3차아파트,42908,1282,5253,1220,5253,62,217
호반베르디움아파트,39922,2484,1599,2451,1599,33,136
호반베르디움아파트107동,92011,2931,136,2901,136,30,102
호반써밋1차 3101동,89393,806,2023,797,2023,9,94
호반써밋1차 3101동,89394,1764,427,1710,427,54,73
호반써밋송도,38637,3412,113,3382,113,30,117
호반써밋송도(109동),38634,119,271,118,271,1,13
호불사입구,38180,2317,3286,2268,3286,49,186
호불사입구,38182,3031,1831,2970,1831,61,162
호세요양원,43221,51,147,46,147,5,6
호세요양원,43311,3,5,2,5,1,0
호수공원,89103,209,741,208,741,1,31
호수공원,89104,2520,925,2510,925,10,114
호수공원음악분수,89027,1694,908,1639,908,55,86
호수공원음악분수,89028,855,1913,840,1913,15,92
호수마을5단지후문,35270,42,52,42,52,0,3
호수마을5단지후문,35735,69,71,69,71,0,4
호수마을이편한세상.한가람우미린,80319,1157,457,1136,457,21,53
홈씨씨인천점,89188,276,661,273,661,3,31
홈플러스,80070,220,2967,219,2967,1,106
홈플러스,89225,550,348,538,348,12,29
홈플러스,35218,251,1445,251,1445,0,56
홈플러스.산림조합,80018,3742,154,3739,154,3,129
홈플러스계산점,41622,46,1257,45,1257,1,43
홍대입구역,23011,98,8225,98,8225,0,277
홍대입구역,23031,47397,455,47320,455,77,1595
홍대입구역,23032,326,21923,324,21923,2,741
홍예문·공영주차장,35794,30,448,28,448,2,15
홍예문·공영주차장,35806,74,505,73,505,1,19
홍의사거리,43798,46,33,40,33,6,2
홍의사거리,43813,44,47,37,47,7,3
홍의삼거리,43441,19,18,17,18,2,1
홍의삼거리,43613,53,50,50,50,3,3
홍익자원,35514,1333,603,1325,603,8,64
홍익자원,35515,58,971,54,971,4,34
홍현마을,90002,40,10,39,10,1,1
홍현마을,90003,10,38,8,38,2,1
화개사입구,90034,1,75,1,75,0,2
화개사입구,90035,88,1,83,1,5,2
화곡역,16147,320,36310,306,36310,14,1221
화곡역,25190,34104,91,33992,91,112,1139
화도,43077,63,115,55,115,8,5
화도고개,36027,2188,2752,2119,2752,69,164
화도고개,36028,1803,4696,1759,4696,44,216
화도돈대,43676,39,2,39,2,0,1
화도돈대,43863,3,40,3,40,0,1
화도진공원.화도진도서관,36033,11179,3464,10969,3464,210,488
화도진공원.화도진도서관,36035,3899,11267,3819,11267,80,505
화도진중학교,36064,3394,666,3243,666,151,135
화도진중학교,36066,888,2905,768,2905,120,126
화도터미널,43104,976,1409,895,1409,81,79
화도터미널,43105,1798,905,1746,905,52,90
화력발전소,42628,208,204,207,204,1,13
화문석문화관,43697,111,0,100,0,11,3
화물터미널,35039,1,242,1,242,0,8
화물터미널,35040,232,17,230,17,2,8
화성보일러,39107,2929,5519,2890,5519,39,281
화성파크드림.스카이시티자이,35651,6007,2009,5862,2009,145,267
화성파크드림후문.한라비발디,35659,542,848,527,848,15,46
화수부두,36147,592,1109,554,1109,38,56
화수사거리,36072,2511,652,2420,652,91,105
화수사거리,36104,260,1349,253,1349,7,53
화전초교사거리,41087,925,1248,916,1248,9,72
화전초등학교,41085,1011,333,1007,333,4,44
화전초등학교,41086,385,437,371,437,14,27
화평철교.화평동냉면거리,36014,2873,3158,2810,3158,63,201
화평철교.화평동냉면거리,36016,15879,21285,15378,21285,501,1238
화훼단지·당미교,41462,134,426,134,426,0,18
화훼단지·당미교,41463,151,204,143,204,8,11
환경공단강화사업소,90109,0,3,0,3,0,0
환경공단강화사업소,90110,4,2,3,2,1,0
황곡노인정,89310,71,0,65,0,6,2
황곡노인정,89320,101,116,83,116,18,7
황곡상회,89311,57,1,56,1,1,1
황곡상회,89330,0,34,0,34,0,1
황골,43992,25,72,22,72,3,3
황골,43993,50,5,47,5,3,1
황골마을,43135,5,20,5,20,0,0
황골마을,43277,30,2,29,2,1,1
황련사입구,43328,63,53,61,53,2,3
황련사입구,43630,22,0,22,0,0,0
황산도,43635,11,39,9,39,2,1
황산도관광밸트,43873,5,0,5,0,0,0
황산도관광밸트,43876,1,17,1,17,0,0
황산도입구,43636,38,14,38,14,0,1
황산도입구,43861,8,16,8,16,0,0
황청리종점,90207,3,0,3,0,0,0
효성2동치안센터,41024,2077,9268,2001,9268,76,378
효성고등학교,41074,2059,794,2013,794,46,95
효성고등학교,41075,760,2691,734,2691,26,115
효성남초등학교,41040,6190,3295,6082,3295,108,316
효성노인문화센터,41409,753,1971,741,1971,12,90
효성노인문화센터,41410,529,894,526,894,3,47
효성농협,41039,2867,1481,2783,1481,84,144
효성뉴서울아파트,41060,15017,1691,14829,1691,188,556
효성뉴서울아파트,41061,2166,13331,2070,13331,96,516
효성뉴서울아파트202동,41078,1448,16829,1397,16829,51,609
효성뉴서울아파트204동,41368,15112,1584,14947,1584,165,556
효성대신아파트,41041,5675,2741,5524,2741,151,280
효성대신아파트,41042,396,3925,386,3925,10,144
효성도서관,41420,2563,359,2540,359,23,97
효성동동화운수차고지,41573,11800,4183,11448,4183,352,532
효성명현초등학교,41065,4065,1005,3903,1005,162,169
효성사거리,41017,1329,4844,1288,4844,41,205
효성사거리,41018,11828,4585,11560,4585,268,547
효성사거리,41019,4932,6670,4837,6670,95,386
효성사거리,41631,903,736,880,736,23,54
효성상아아파트,39357,13449,16069,13264,16069,185,983
효성상아아파트,39358,18341,12978,18156,12978,185,1043
효성서초등학교,41557,2639,408,2618,408,21,101
효성서초등학교,41558,361,2265,360,2265,1,87
효성서초등학교,41579,196,1034,196,1034,0,41
효성서초등학교,41580,1736,536,1718,536,18,75
효성성모병원,41022,5899,246,5804,246,95,204
효성소방파출소,41023,9236,2975,9090,2975,146,407
효성신사거리,41030,1589,7747,1507,7747,82,311
효성신사거리,41031,7321,1387,7167,1387,154,290
효성아파트,42166,9258,2760,9144,2760,114,400
효성아파트,42168,2756,7430,2723,7430,33,339
효성중앙교회,41021,166,7309,112,7309,54,249
효성프라자,41052,7006,8311,6803,8311,203,510
효성프라자,41055,6360,5333,6197,5333,163,389
효성현대3차,41049,1284,3249,1220,3249,64,151
효성현대3차아파트,41051,911,572,877,572,34,49
효성현대4차,41035,3049,4577,2830,4577,219,254
효성현대4차아파트,41036,4790,2012,4709,2012,81,226
효자교앞,90199,7,2,7,2,0,0
효자교앞,90200,4,13,4,13,0,0
효정아파트,38260,1011,1562,988,1562,23,85
후정초등학교.삼산도서관,40685,46,1245,43,1245,3,43
후지테크,39051,2021,1263,2001,1263,20,109
후지테크,39052,462,1951,461,1951,1,80
후포항입구,43431,15,87,14,87,1,3
후포항입구,43481,32,5,29,5,3,1
휴먼시아1단지,40837,3794,6466,3721,6466,73,342
휴먼시아1단지,40838,6336,2415,6246,2415,90,291
휴먼시아1단지,40840,973,0,935,0,38,32
휴먼시아1단지,40852,336,1815,231,1815,105,71
휴먼시아후문,42885,9851,3823,9661,3823,190,455
흥륜사입구,38723,12,15,11,15,1,0
흥륜사입구,38724,9,18,9,18,0,0
흥성리,18804,16,244,16,244,0,8
흥성리,62029,188,17,186,17,2,6
흥왕2리마을회관 앞,43122,24,23,21,23,3,1
흥왕2리마을회관 앞,43520,25,25,22,25,3,1
흥왕리,90073,0,22,0,22,0,0
흥왕리,90074,18,13,14,13,4,1
흥왕상회,43502,31,45,31,45,0,2
흥왕상회,43516,36,6,32,6,4,1
희경산업·남동스카이장례식장,39031,212,93,209,93,3,10
희경산업·남동스카이장례식장,39961,17,304,16,304,1,10
희망찬요양병원,38126,4065,6667,3988,6667,77,357
희망천입구,40091,5558,4698,5407,4698,151,341
희망천입구,40799,6076,5612,5985,5612,91,389
희망체육공원입구,40912,5256,54,4950,54,306,177
희성금속,42018,114,528,113,528,1,21
힐데스하임,42876,10045,2935,9842,2935,203,432
힐스테이트,35457,15577,10120,15374,10120,203,856
힐스테이트,35458,6244,5325,6013,5325,231,385
힐스테이트레이크송도(후문),38630,2242,1761,2218,1761,24,133
힐스테이트레이크송도(후문),38656,2217,1706,2155,1706,62,130
힐스테이트레이크송도1차입구,38655,990,1235,965,1235,25,74
힐스테이트레이크송도2차(201동),38641,1455,1967,1430,1967,25,114
힐스테이트레이크송도2차(201동),38657,1727,729,1700,729,27,81
힐스테이트송도더테라스(정문),38715,1156,245,1112,245,44,46
힐스테이트송도더테라스(정문),38716,210,646,201,646,9,28
힐스테이트송도더테라스(후문),38713,2525,2274,2373,2274,152,159
힐스테이트송도더테라스(후문),38714,615,2188,556,2188,59,93
힐스테이트푸르지오주안,37293,21163,31213,20718,31213,445,1745
힐스테이트학익,37022,5299,3668,5146,3668,153,298
힐스테이트학익,37023,3561,7157,3500,7157,61,357
힐스테이트학익104동앞,37669,831,1546,811,1546,20,79
힐스테이트학익104동앞,37670,1515,4623,1496,4623,19,204
힐캐슬프라자,39329,10682,14853,10473,14853,209,851
힐캐슬프라자,39331,16495,8840,16057,8840,438,844
힘찬병원,40891,5072,6884,5018,6884,54,398
힘찬병원,40892,3775,3084,3693,3084,82,228
